subject	predicate	object	isCitizenOf
<Somalia>	<dealsWith>	<United_Arab_Emirates>	<Nigeria>
<Billy_Davies>	<isAffiliatedTo>	<Nottingham_Forest_F.C.>	<Dominica>
<Traianos_Dellas>	<isAffiliatedTo>	<Atromitos_F.C.>	<Nigeria>
<Richard_Jenkins>	<actedIn>	<The_Cabin_in_the_Woods>	<Scotland>
<Anne_Bancroft>	<isMarriedTo>	<Mel_Brooks>	<Barbados>
<Christian_Eduardo_Giménez>	<isAffiliatedTo>	<Hertha_BSC>	<Netherlands>
<Carlo_Nash>	<isAffiliatedTo>	<Wolverhampton_Wanderers_F.C.>	<Democratic_Republic_of_the_Congo>
<Colin_Gordon_(footballer)>	<playsFor>	<Leicester_City_F.C.>	<Slovenia>
<SkyTeam>	<isLocatedIn>	<Netherlands>	<Russia>
<General_Dynamics>	<isLocatedIn>	<Fairfax_County,_Virginia>	<Austria>
<Russian_Empire>	<participatedIn>	<War_of_the_Fourth_Coalition>	<India>
<Leroy_Chambers>	<wasBornIn>	<Sheffield>	<Scotland>
<Angela_Lansbury>	<hasWonPrize>	<Laurence_Olivier_Award>	<Germany>
<Groucho_Marx>	<influences>	<Brendon_Small>	<Puerto_Rico>
<Evan_Rachel_Wood>	<actedIn>	<The_Wrestler_(2008_film)>	<Poland>
<Hans_Zimmer>	<wroteMusicFor>	<The_Da_Vinci_Code_(film)>	<United_Arab_Emirates>
<Carl_Bradshaw_(footballer)>	<isAffiliatedTo>	<Manchester_City_F.C.>	<India>
<Bridesmaids_(2011_film)>	<isLocatedIn>	<United_States>	<Croatia>
<Cicely_Tyson>	<wasBornIn>	<New_York_City>	<Puerto_Rico>
<Kevin_McLeod_(footballer)>	<isAffiliatedTo>	<Everton_F.C.>	<El_Salvador>
<Robert_Silverberg>	<hasWonPrize>	<Nebula_Award>	<Scotland>
<Sam_Jennings>	<isAffiliatedTo>	<West_Ham_United_F.C.>	<Chile>
<Sam_Neill>	<actedIn>	<Evil_Angels_(film)>	<Switzerland>
<Alfie_Conn_Jr.>	<isAffiliatedTo>	<Blackpool_F.C.>	<Australia>
<Paul_Musselwhite>	<isAffiliatedTo>	<Portsmouth_F.C.>	<Italy>
<Danny_Coyne>	<isAffiliatedTo>	<Middlesbrough_F.C.>	<Puerto_Rico>
<Elia_Kazan>	<directed>	<On_the_Waterfront>	<Dominica>
<Joe_Pasternak>	<wasBornIn>	<Austria-Hungary>	<Italy>
<Percy_Whipp>	<playsFor>	<Swindon_Town_F.C.>	<Canada>
<Bill_Pullman>	<actedIn>	<Lucky_Numbers>	<Canada>
<Nathan_Koo-Boothe>	<playsFor>	<Farnborough_F.C.>	<Serbia>
<Ernie_Watkins_(footballer,_born_1898)>	<isAffiliatedTo>	<Fulham_F.C.>	<Kazakhstan>
<John_Lowey_(footballer)>	<isAffiliatedTo>	<Manchester_United_F.C.>	<France>
<Greece>	<participatedIn>	<Nicaraguan_Revolution>	<Scotland>
<War_of_the_First_Coalition>	<happenedIn>	<Kingdom_of_Great_Britain>	<Republic_of_the_Congo>
<Dominic_West>	<actedIn>	<Hannibal_Rising_(film)>	<Argentina>
<Columbia,_South_Carolina>	<isLocatedIn>	<South_Carolina>	<Brazil>
<John_Michael_Higgins>	<actedIn>	<Evan_Almighty>	<Belgium>
<Young_Adam_(film)>	<isLocatedIn>	<United_Kingdom>	<Bahrain>
<Tommy_Chong>	<wasBornIn>	<Edmonton>	<Serbia>
<Saint_Petersburg_State_University>	<isLocatedIn>	<Saint_Petersburg>	<Wales>
<Julia_Stiles>	<graduatedFrom>	<Columbia_University>	<Italy>
<Sylvia_Sidney>	<diedIn>	<New_York>	<Japan>
<I_Love_You_Phillip_Morris>	<isLocatedIn>	<United_States>	<Iran>
<Denmark>	<dealsWith>	<United_States>	<Ukraine>
<Dougie_Freedman>	<isAffiliatedTo>	<Southend_United_F.C.>	<England>
<War_of_the_Fourth_Coalition>	<happenedIn>	<Germany>	<Denmark>
<The_Vow_(2012_film)>	<isLocatedIn>	<United_States>	<Canada>
<József_Viola>	<isAffiliatedTo>	<Vicenza_Calcio>	<Martinique>
<Loïc_Rémy>	<playsFor>	<Olympique_Lyonnais>	<Poland>
<Ian_James_Corlett>	<livesIn>	<Palm_Springs,_California>	<Russia>
<Carter_Burwell>	<wroteMusicFor>	<Velvet_Goldmine>	<El_Salvador>
<Ismaïl_Aissati>	<isAffiliatedTo>	<SBV_Vitesse>	<Poland>
<John_Guidetti>	<isAffiliatedTo>	<Celtic_F.C.>	<Panama>
<Darren_Byfield>	<isAffiliatedTo>	<Millwall_F.C.>	<Hungary>
<Gustave_Flaubert>	<influences>	<George_Orwell>	<France>
<Fred_Pagnam>	<playsFor>	<Watford_F.C.>	<Barbados>
<Electric_Daisy_Carnival>	<isLocatedIn>	<Dallas>	<Japan>
<Joe_Bradshaw_(footballer)>	<isAffiliatedTo>	<Fulham_F.C.>	<Jamaica>
<Jack_Warden>	<actedIn>	<Bulworth>	<Tanzania>
<Kari_Wahlgren>	<livesIn>	<Los_Angeles>	<Monaco>
<Arthur_Phoenix>	<playsFor>	<Shelbourne_F.C.>	<Slovenia>
<Youssouf_Hersi>	<isAffiliatedTo>	<Perth_Glory_FC>	<Bulgaria>
<Karim_Rekik>	<wasBornIn>	<The_Hague>	<Argentina>
<Carmine_Gautieri>	<isAffiliatedTo>	<A.S._Livorno_Calcio>	<United_Arab_Emirates>
<The_Culinary_Institute_of_America>	<isLocatedIn>	<New_York>	<Ukraine>
<Eminem>	<wasBornIn>	<St._Joseph,_Missouri>	<Tanzania>
<David_Ogden_Stiers>	<actedIn>	<The_Hunchback_of_Notre_Dame_(1996_film)>	<Netherlands>
<Colin_Cramb>	<isAffiliatedTo>	<Bristol_City_F.C.>	<Scotland>
<John_Guidetti>	<isAffiliatedTo>	<Manchester_City_F.C.>	<Panama>
<Alex_Gibney>	<graduatedFrom>	<Yale_University>	<United_States>
<René_Descartes>	<graduatedFrom>	<Leiden_University>	<Sweden>
<Milan>	<owns>	<A.C._Milan>	<Cape_Verde>
<Tom_Flanagan_(footballer)>	<isAffiliatedTo>	<Barnet_F.C.>	<Italy>
<Alan_Bennett_(footballer,_born_1981)>	<isAffiliatedTo>	<Cheltenham_Town_F.C.>	<Bahrain>
<Terrence_McNally>	<hasWonPrize>	<Tony_Award>	<Austria>
<Jason_Banton>	<isAffiliatedTo>	<Milton_Keynes_Dons_F.C.>	<Republic_of_Ireland>
<Henri_Lansbury>	<isAffiliatedTo>	<Nottingham_Forest_F.C.>	<Martinique>
<Nicolas_Cage>	<actedIn>	<Face/Off>	<Greece>
<Poland>	<hasNeighbor>	<Ukraine>	<Serbia>
<Jason_Lee_(footballer)>	<isAffiliatedTo>	<Nottingham_Forest_F.C.>	<Chile>
<Vladimir_Petrović>	<isAffiliatedTo>	<Red_Star_Belgrade>	<Nigeria>
<El_Salvador>	<dealsWith>	<China>	<India>
<The_Haunting_(1999_film)>	<isLocatedIn>	<United_States>	<United_Kingdom>
<Fred_Bevan>	<playsFor>	<Bury_F.C.>	<Nigeria>
<Jason_van_Blerk>	<isAffiliatedTo>	<Millwall_F.C.>	<Canada>
<Amelia_(film)>	<isLocatedIn>	<Canada>	<Canada>
<Lesser_Antilles>	<isLocatedIn>	<Anguilla>	<Serbia>
<Brett_Angell>	<isAffiliatedTo>	<Walsall_F.C.>	<Barbados>
<Esteban_Cambiasso>	<wasBornIn>	<Buenos_Aires>	<Northern_Ireland>
<César_Prates>	<isAffiliatedTo>	<A.C._ChievoVerona>	<Cameroon>
<Diane_Warren>	<hasWonPrize>	<APRA_Awards_(Australia)>	<Germany>
<Danny_Andrew>	<playsFor>	<Macclesfield_Town_F.C.>	<Cape_Verde>
<Jérôme_Leroy_(footballer)>	<isAffiliatedTo>	<FC_Istres>	<Canada>
<Jamie_Day_(footballer,_born_1979)>	<isAffiliatedTo>	<Ebbsfleet_United_F.C.>	<Cameroon>
<Dennis_Bailey_(footballer,_born_1965)>	<isAffiliatedTo>	<Birmingham_City_F.C.>	<Belgium>
<Rory_Fallon>	<isAffiliatedTo>	<Barnsley_F.C.>	<Brazil>
<Stephen_Dawson>	<isAffiliatedTo>	<Mansfield_Town_F.C.>	<Martinique>
<Matteo_Brighi>	<playsFor>	<A.C._ChievoVerona>	<Austria>
<Vince_Gilligan>	<hasWonPrize>	<Writers_Guild_of_America_Award>	<Denmark>
<Stark_County,_Ohio>	<isLocatedIn>	<Canton,_Ohio>	<Bangladesh>
<Donal_Murphy>	<isAffiliatedTo>	<Shelbourne_F.C.>	<Croatia>
<Chicago_metropolitan_area>	<isLocatedIn>	<Elgin,_Illinois>	<Kazakhstan>
<1932_Summer_Olympics>	<isLocatedIn>	<Los_Angeles>	<Cyprus>
<Jon_Parkin>	<playsFor>	<Cardiff_City_F.C.>	<Germany>
<Harvey_Weinstein>	<created>	<The_Weinstein_Company>	<Serbia>
<Lawrence_Kasdan>	<directed>	<Wyatt_Earp_(film)>	<Cameroon>
<Eastern_Kentucky_University>	<isLocatedIn>	<Kentucky>	<Northern_Ireland>
<Ramón_Núñez>	<isAffiliatedTo>	<Puebla_F.C.>	<Argentina>
<Michael_Shannon>	<actedIn>	<Take_Shelter>	<Chile>
<Rolando_Bianchi>	<isAffiliatedTo>	<Bologna_F.C._1909>	<Poland>
<Andy_Dow>	<wasBornIn>	<Dundee>	<Bulgaria>
<Jacques_Derrida>	<influences>	<Edward_Said>	<Democratic_Republic_of_the_Congo>
<Jonathan_Swift>	<graduatedFrom>	<Trinity_College,_Dublin>	<Austria>
<Chevy_Chase>	<wasBornIn>	<New_York_City>	<Nigeria>
<Douglas_Adams>	<wasBornIn>	<Cambridge>	<England>
<Ramon_Menezes>	<playsFor>	<Al-Gharafa_Sports_Club>	<France>
<Megan_Fox>	<actedIn>	<Jonah_Hex_(film)>	<Germany>
<Mel_Gibson>	<actedIn>	<Gallipoli_(1981_film)>	<Kazakhstan>
<Ludwig_Wittgenstein>	<influences>	<Isaiah_Berlin>	<Nigeria>
<Giovanni_Sio>	<isAffiliatedTo>	<SC_Bastia>	<Martinique>
<Elizabeth_Banks>	<graduatedFrom>	<University_of_Pennsylvania>	<Greece>
<Mel_Brooks>	<wasBornIn>	<Brooklyn>	<Italy>
<Rebecca_Hall>	<actedIn>	<The_Town_(2010_film)>	<Bulgaria>
<Graham_Potter>	<playsFor>	<Stoke_City_F.C.>	<Belgium>
<Dean_Holdsworth>	<isAffiliatedTo>	<Port_Vale_F.C.>	<Panama>
<Steve_Zahn>	<hasWonPrize>	<Independent_Spirit_Awards>	<Kazakhstan>
<Brian_Birch>	<isAffiliatedTo>	<Helsingborgs_IF>	<Nigeria>
<Saddam_Hussein>	<isPoliticianOf>	<Iraq>	<Japan>
<Bill_McGarry>	<isAffiliatedTo>	<Huddersfield_Town_A.F.C.>	<Cameroon>
<David_Beckham>	<isAffiliatedTo>	<England_national_football_team>	<Jamaica>
<Larry_Fine>	<diedIn>	<Los_Angeles>	<Germany>
<Mychael_Danna>	<wroteMusicFor>	<Girl,_Interrupted_(film)>	<Bulgaria>
<Niels_Bohr>	<wasBornIn>	<Copenhagen>	<Wales>
<Simon_Gillett>	<isAffiliatedTo>	<Southampton_F.C.>	<Cameroon>
<21st_Academy_Awards>	<isLocatedIn>	<United_States>	<England>
<Hartford_Wolf_Pack>	<isLocatedIn>	<Hartford,_Connecticut>	<Croatia>
<Amartya_Sen>	<livesIn>	<New_York>	<Bangladesh>
<Sanctuary_Records>	<isLocatedIn>	<England>	<Switzerland>
<Graham_Roberts>	<isAffiliatedTo>	<West_Bromwich_Albion_F.C.>	<Puerto_Rico>
<Axis_powers>	<participatedIn>	<World_War_II>	<Austria>
<Union_of_South_Africa>	<participatedIn>	<Korean_War>	<Wales>
<Daniel_Nardiello>	<isAffiliatedTo>	<Plymouth_Argyle_F.C.>	<Martinique>
<William_Thomson,_1st_Baron_Kelvin>	<livesIn>	<Cambridge>	<England>
<Sam_Jennings>	<playsFor>	<Burnley_F.C.>	<Chile>
<Dele_Adebola>	<isAffiliatedTo>	<Bristol_City_F.C.>	<Puerto_Rico>
<Mandatory_Palestine>	<participatedIn>	<Italian_Campaign_(World_War_II)>	<Senegal>
<Alex_Borstein>	<wasBornIn>	<Highland_Park,_Illinois>	<United_States>
<Jon_Shaw>	<isAffiliatedTo>	<Mansfield_Town_F.C.>	<Norway>
<Elizabeth_McGovern>	<wasBornIn>	<Evanston,_Illinois>	<Democratic_Republic_of_the_Congo>
<Mark_Nicholls>	<playsFor>	<Partick_Thistle_F.C.>	<Switzerland>
<Don_Weston>	<isAffiliatedTo>	<Altrincham_F.C.>	<Jamaica>
<India>	<participatedIn>	<Operation_Enduring_Freedom_–_Horn_of_Africa>	<Norway>
<Josh_Wright>	<isAffiliatedTo>	<Charlton_Athletic_F.C.>	<France>
<Bertrand_Bossu>	<isAffiliatedTo>	<Gillingham_F.C.>	<Poland>
<Raúl_Díaz_Arce>	<playsFor>	<San_Jose_Earthquakes>	<United_Kingdom>
<Colin_Hendry>	<isAffiliatedTo>	<Blackpool_F.C.>	<Martinique>
<Rosario_Dawson>	<wasBornIn>	<New_York_City>	<Australia>
<Armand_Assante>	<actedIn>	<American_Gangster_(film)>	<Bulgaria>
<Ian_Hendon>	<isAffiliatedTo>	<Northampton_Town_F.C.>	<Germany>
<Darius_Henderson>	<isAffiliatedTo>	<Mansfield_Town_F.C.>	<England>
<Peter_Taylor_(footballer,_born_1953)>	<isAffiliatedTo>	<Wycombe_Wanderers_F.C.>	<Netherlands>
<St._Louis_Blues>	<isLocatedIn>	<Missouri>	<Republic_of_Ireland>
<Will_Ferrell>	<actedIn>	<Bewitched_(2005_film)>	<United_States>
<Paul_Allen_(footballer)>	<isAffiliatedTo>	<West_Ham_United_F.C.>	<Republic_of_the_Congo>
<Gavin_Heeroo>	<playsFor>	<Grays_Athletic_F.C.>	<China>
<Kelly_Preston>	<actedIn>	<Jerry_Maguire>	<Northern_Ireland>
<Steve_Leo_Beleck>	<playsFor>	<ACF_Fiorentina>	<Belgium>
<Lee_Fowler>	<isAffiliatedTo>	<Kidderminster_Harriers_F.C.>	<Bulgaria>
<George_Berry_(footballer)>	<isAffiliatedTo>	<Stoke_City_F.C.>	<Netherlands>
<Scouting_in_California>	<isLocatedIn>	<Sacramento,_California>	<Republic_of_the_Congo>
<Enrico_Fermi>	<worksAt>	<Columbia_University>	<United_States>
<Fred_Williamson>	<actedIn>	<From_Dusk_till_Dawn>	<Hungary>
<Peter_Shilton>	<wasBornIn>	<Leicester>	<Democratic_Republic_of_the_Congo>
<Tim_Blake_Nelson>	<wasBornIn>	<Tulsa,_Oklahoma>	<Nigeria>
<Denmark>	<participatedIn>	<Kosovo_War>	<Ukraine>
<Song_Chong-gug>	<isAffiliatedTo>	<South_Korea_national_football_team>	<Israel>
<Trésor_Kandol>	<isAffiliatedTo>	<Millwall_F.C.>	<Republic_of_the_Congo>
<Abel_Xavier>	<isAffiliatedTo>	<Middlesbrough_F.C.>	<Monaco>
<UEFA>	<isLocatedIn>	<Europe>	<United_Arab_Emirates>
<Nathan_Byrne>	<isAffiliatedTo>	<Wolverhampton_Wanderers_F.C.>	<Wales>
<Tim_Sherwood>	<isAffiliatedTo>	<Coventry_City_F.C.>	<Poland>
<Lucas_Silva_(footballer,_born_1984)>	<isAffiliatedTo>	<Tiburones_Rojos_de_Veracruz>	<France>
<Willem_Dafoe>	<actedIn>	<Mississippi_Burning>	<Israel>
<Luciano_Figueroa>	<playsFor>	<Genoa_C.F.C.>	<Serbia>
<Stefano_Lombardi>	<isAffiliatedTo>	<A.C._Perugia_Calcio>	<Norway>
<Confederate_States_of_America>	<participatedIn>	<American_Civil_War>	<Kazakhstan>
<Orlando_Engelaar>	<isAffiliatedTo>	<K.R.C._Genk>	<Sweden>
<Girl,_Interrupted_(film)>	<isLocatedIn>	<United_States>	<El_Salvador>
<Jyothika>	<hasWonPrize>	<Filmfare_Awards_South>	<Chile>
<Wendy_Melvoin>	<created>	<Heroes_(TV_series)>	<Barbados>
<In_Your_House>	<isLocatedIn>	<Florida>	<Greece>
<John_Michael_Higgins>	<actedIn>	<For_Your_Consideration_(film)>	<Belgium>
<Maurizio_Iorio>	<isAffiliatedTo>	<F.C._Bari_1908>	<Hungary>
<Ralph_Fiennes>	<actedIn>	<Sunshine_(1999_film)>	<Poland>
<Geoff_Scott_(footballer)>	<isAffiliatedTo>	<Cambridge_United_F.C.>	<Northern_Ireland>
<Ned_Beatty>	<wasBornIn>	<Louisville,_Kentucky>	<Netherlands>
<Angels_&_Airwaves_Presents_Love_Live>	<isLocatedIn>	<Georgia_(U.S._state)>	<Israel>
<Patrick_Agyemang>	<playsFor>	<Stevenage_F.C.>	<Croatia>
<Tom_Green>	<isMarriedTo>	<Drew_Barrymore>	<Jamaica>
<Alan_Thompson_(footballer,_born_1973)>	<isAffiliatedTo>	<England_national_football_team>	<Croatia>
<Ed_Asner>	<actedIn>	<Rich_Man,_Poor_Man_(miniseries)>	<Croatia>
<Keith_Edwards_(footballer,_born_1957)>	<isAffiliatedTo>	<Stockport_County_F.C.>	<Wales>
<Roberto_Benigni>	<directed>	<Pinocchio_(2002_film)>	<Niger>
<Edward_G._Robinson>	<actedIn>	<The_Ten_Commandments_(1956_film)>	<China>
<France>	<participatedIn>	<International_Force_for_East_Timor>	<Iran>
<Sam_Jennings>	<playsFor>	<Olympique_de_Marseille>	<Chile>
<Jack_Haines>	<isAffiliatedTo>	<Wrexham_A.F.C.>	<Argentina>
<Tom_Skerritt>	<actedIn>	<MASH_(film)>	<United_Arab_Emirates>
<Kaba_Diawara>	<isAffiliatedTo>	<Stade_Rennais_F.C.>	<Jamaica>
<Giovani_dos_Santos>	<isAffiliatedTo>	<Tottenham_Hotspur_F.C.>	<Republic_of_the_Congo>
<Brad_Friedel>	<isAffiliatedTo>	<United_States_men's_national_soccer_team>	<Slovenia>
<James_Wallace_(footballer,_born_1991)>	<wasBornIn>	<Liverpool>	<Bahrain>
<Jack_Reynolds_(footballer,_born_1869)>	<isAffiliatedTo>	<Aston_Villa_F.C.>	<Belgium>
<Dorothy_Fields>	<diedIn>	<New_York_City>	<Switzerland>
<Art_Center_College_of_Design>	<isLocatedIn>	<Pasadena,_California>	<Monaco>
<Asia_Argento>	<actedIn>	<Marie_Antoinette_(2006_film)>	<Brazil>
<Jermaine_Pennant>	<isAffiliatedTo>	<Wigan_Athletic_F.C.>	<Spain>
<Richard_Chamberlain>	<wasBornIn>	<Beverly_Hills,_California>	<Norway>
<Marco_Baroni>	<isAffiliatedTo>	<Delfino_Pescara_1936>	<Panama>
<John_Eustace>	<isAffiliatedTo>	<Coventry_City_F.C.>	<Tanzania>
<Santa_Rosa,_California>	<isLocatedIn>	<United_States>	<Australia>
<Mark_Wilson_(English_footballer)>	<isAffiliatedTo>	<Walsall_F.C.>	<Serbia>
<Arcadia,_California>	<isLocatedIn>	<Los_Angeles_County,_California>	<Japan>
<Romania>	<dealsWith>	<Netherlands>	<United_Arab_Emirates>
<Iraq_War>	<happenedIn>	<Iraq>	<Israel>
<John_Burridge>	<playsFor>	<Manchester_City_F.C.>	<Denmark>
<Martin_Paterson>	<playsFor>	<Port_Vale_F.C.>	<Russia>
<North_Dakota>	<isLocatedIn>	<United_States>	<Dominica>
<Jeffrey_Monakana>	<isAffiliatedTo>	<Bristol_Rovers_F.C.>	<Bulgaria>
<Horace_Brindley>	<playsFor>	<Norwich_City_F.C.>	<Nigeria>
<In_Your_House>	<isLocatedIn>	<Canada>	<Greece>
<Antony_Sher>	<hasWonPrize>	<Drama_Desk_Award>	<Democratic_Republic_of_the_Congo>
<Luc_Besson>	<wasBornIn>	<Paris>	<Nigeria>
<Dominic_West>	<livesIn>	<Hammersmith>	<Argentina>
<Richard_Walker_(footballer,_born_1977)>	<isAffiliatedTo>	<Aston_Villa_F.C.>	<Norway>
<Maurizio_Iorio>	<isAffiliatedTo>	<Inter_Milan>	<Hungary>
<Richard_Dreyfuss>	<actedIn>	<The_Goodbye_Girl>	<El_Salvador>
<Maicon_Santos>	<playsFor>	<FC_Dallas>	<Chile>
<Jake_Edwards_(footballer,_born_1976)>	<wasBornIn>	<Manchester>	<Sweden>
<Phil_Marsh>	<playsFor>	<Barrow_A.F.C.>	<Greece>
<Gordon_Hill_(footballer)>	<isAffiliatedTo>	<Derby_County_F.C.>	<Niger>
<Kingdom_of_Naples>	<hasCapital>	<Naples>	<Martinique>
<Ghana>	<hasOfficialLanguage>	<English_language>	<Israel>
<Liam_Miller>	<isAffiliatedTo>	<Brisbane_Roar_FC>	<Spain>
<Ireland>	<participatedIn>	<United_Nations_Operation_in_Somalia_II>	<Italy>
<Billy_Crudup>	<graduatedFrom>	<University_of_North_Carolina_at_Chapel_Hill>	<Wales>
<Aldo_Duscher>	<isAffiliatedTo>	<RCD_Espanyol>	<Italy>
<Michael_Stipe>	<wasBornIn>	<Decatur,_Georgia>	<Russia>
<Philip_Pullman>	<hasWonPrize>	<Astrid_Lindgren_Memorial_Award>	<Bangladesh>
<Emory_University>	<isLocatedIn>	<United_States>	<Iran>
<Rubén_González_Rocha>	<playsFor>	<FC_Baku>	<Hungary>
<Berkshire>	<isLocatedIn>	<South_East_England>	<Austria>
<Snoop_Dogg>	<actedIn>	<Starsky_&_Hutch_(film)>	<Monaco>
<Ivory_Coast>	<dealsWith>	<China>	<Bulgaria>
<State_highways_serving_Virginia_state_institutions>	<isLocatedIn>	<Fredericksburg,_Virginia>	<Panama>
<Kevin_Smith>	<created>	<Jersey_Girl_(2004_film)>	<Japan>
<2013–14_chikungunya_outbreak>	<happenedIn>	<Cayman_Islands>	<Cameroon>
<Will_Buckley_(footballer)>	<isAffiliatedTo>	<Leeds_United_F.C.>	<India>
<Robert_F._Kennedy>	<diedIn>	<Los_Angeles>	<Mali>
<Netherlands>	<participatedIn>	<Libyan_Civil_War_(2011)>	<Bangladesh>
<Ben_Smith_(footballer,_born_1978)>	<isAffiliatedTo>	<Arsenal_F.C.>	<Belgium>
<Bobby_Olejnik>	<isAffiliatedTo>	<Falkirk_F.C.>	<El_Salvador>
<Salt_(2010_film)>	<isLocatedIn>	<United_States>	<Dominica>
<Matt_Stone>	<hasWonPrize>	<Laurence_Olivier_Award>	<Greece>
<Gérson_Magrão>	<isAffiliatedTo>	<Clube_de_Regatas_do_Flamengo>	<Kazakhstan>
<Billy_Hendry>	<playsFor>	<Dundee_F.C.>	<Bulgaria>
<Brian_Taylor_(footballer,_born_1937)>	<isAffiliatedTo>	<Shrewsbury_Town_F.C.>	<Australia>
<Joni_Mitchell>	<hasWonPrize>	<Grammy_Lifetime_Achievement_Award>	<Canada>
<David_O._Russell>	<wasBornIn>	<Manhattan>	<Martinique>
<Emma_Thompson>	<actedIn>	<Angels_in_America_(miniseries)>	<China>
<Dave_Norton>	<playsFor>	<Hull_City_A.F.C.>	<Republic_of_Ireland>
<Harry_Warren>	<wasBornIn>	<Brooklyn>	<Austria>
<Guylain_Ndumbu-Nsungu>	<isAffiliatedTo>	<Darlington_F.C.>	<Chile>
<Dennis_Wann>	<isAffiliatedTo>	<Chester_City_F.C.>	<Panama>
<Toni_Silva>	<isAffiliatedTo>	<Northampton_Town_F.C.>	<Panama>
<Rudi_Skácel>	<isAffiliatedTo>	<Southampton_F.C.>	<Italy>
<Lee_J._Cobb>	<actedIn>	<The_Exorcist_(film)>	<Russia>
<Carole_Lombard>	<wasBornIn>	<Fort_Wayne,_Indiana>	<Chile>
<Ian_Stevens_(footballer)>	<isAffiliatedTo>	<Wrexham_A.F.C.>	<Wales>
<Jason_Harris_(footballer,_born_1976)>	<isAffiliatedTo>	<Crystal_Palace_F.C.>	<Australia>
<Peter_Berg>	<directed>	<Battleship_(film)>	<Croatia>
<Georg_Wilhelm_Friedrich_Hegel>	<influences>	<Fredric_Jameson>	<Belgium>
<India>	<hasCurrency>	<Indian_rupee>	<Norway>
<Tokyo>	<isLocatedIn>	<Japan>	<Greece>
<Greg_Halford>	<playsFor>	<Cardiff_City_F.C.>	<Serbia>
<Walt_Disney_Studios_Motion_Pictures>	<isLocatedIn>	<Burbank,_California>	<Brazil>
<Emile_Hirsch>	<actedIn>	<Milk_(film)>	<Senegal>
<Danny_Elfman>	<wroteMusicFor>	<A_Simple_Plan_(film)>	<Bangladesh>
<Tommy_Anderson_(footballer)>	<isAffiliatedTo>	<A.F.C._Bournemouth>	<Serbia>
<Stuart_Parker_(footballer)>	<playsFor>	<Blackburn_Rovers_F.C.>	<Martinique>
<Lee_Thorpe>	<isAffiliatedTo>	<Brentford_F.C.>	<Martinique>
<Chris_Adamson>	<isAffiliatedTo>	<Stockport_County_F.C.>	<Cyprus>
<Rwanda>	<hasNeighbor>	<Democratic_Republic_of_the_Congo>	<Japan>
<Clyde_Wijnhard>	<isAffiliatedTo>	<FC_Groningen>	<Senegal>
<Edward_Said>	<wasBornIn>	<Jerusalem>	<Mali>
<Adel_Taarabt>	<isAffiliatedTo>	<RC_Lens>	<India>
<Frances_McDormand>	<hasWonPrize>	<Drama_Desk_Award>	<Nigeria>
<Eric_Wynalda>	<isAffiliatedTo>	<Atlanta_Silverbacks>	<Spain>
<Frances_McDormand>	<actedIn>	<Short_Cuts_(film)>	<Nigeria>
<Normandy>	<isLocatedIn>	<Rouen>	<Niger>
<The_Scorpion_King>	<isLocatedIn>	<Germany>	<Cape_Verde>
<Simon_Webster_(footballer)>	<isAffiliatedTo>	<Sheffield_United_F.C.>	<Mali>
<Geoff_Thomas_(footballer,_born_1964)>	<playsFor>	<Rochdale_A.F.C.>	<Serbia>
<Trevor_Aylott>	<isAffiliatedTo>	<Crystal_Palace_F.C.>	<Jamaica>
<Bruno_Rodriguez>	<isAffiliatedTo>	<AS_Monaco_FC>	<Russia>
<Colombia>	<hasOfficialLanguage>	<Spanish_language>	<Brazil>
<Don_Knotts>	<diedIn>	<Los_Angeles>	<Republic_of_Ireland>
<Emerson_Thome>	<isAffiliatedTo>	<Derby_County_F.C.>	<China>
<Carol_Burnett>	<hasWonPrize>	<Primetime_Emmy_Award>	<United_States>
<Ben_Gordon_(footballer,_born_1991)>	<wasBornIn>	<Bradford>	<Scotland>
<Arthur_Miller>	<wasBornIn>	<Harlem>	<Puerto_Rico>
<Scott_Davies_(footballer,_born_1988)>	<isAffiliatedTo>	<Aldershot_Town_F.C.>	<Ukraine>
<Mike_Basham>	<playsFor>	<Grays_Athletic_F.C.>	<United_Kingdom>
<Danny_Graham_(footballer)>	<isAffiliatedTo>	<Blackpool_F.C.>	<Slovenia>
<Andy_Linighan>	<isAffiliatedTo>	<Arsenal_F.C.>	<Republic_of_the_Congo>
<Brad_Jones_(footballer)>	<playsFor>	<Sheffield_Wednesday_F.C.>	<Nigeria>
<Matt_Dillon>	<actedIn>	<There's_Something_About_Mary>	<Norway>
<Kyle_MacLachlan>	<actedIn>	<The_Flintstones_(film)>	<Cameroon>
<Greg_Pearson>	<playsFor>	<Kidderminster_Harriers_F.C.>	<Australia>
<Chicago_metropolitan_area>	<isLocatedIn>	<Evanston,_Illinois>	<Kazakhstan>
<Djamel_Abdoun>	<isAffiliatedTo>	<CS_Sedan_Ardennes>	<Poland>
<Chris_Coyne>	<playsFor>	<Australia_national_soccer_team>	<United_Kingdom>
<Kinji_Fukasaku>	<diedIn>	<Tokyo>	<Germany>
<Perry_Suckling>	<isAffiliatedTo>	<SuperSport_United_F.C.>	<Republic_of_Ireland>
<Brendan_Gleeson>	<actedIn>	<The_Village_(2004_film)>	<Dominica>
<Bas-Rhin>	<isLocatedIn>	<France>	<Spain>
<Ray_Liotta>	<actedIn>	<Smokin'_Aces>	<United_States>
<Iago_Falque>	<playsFor>	<Genoa_C.F.C.>	<Canada>
<Stefano_Lombardi>	<playsFor>	<A.C._Perugia_Calcio>	<Norway>
<Jim_McCalliog>	<isAffiliatedTo>	<Southampton_F.C.>	<El_Salvador>
<Lee_McEvilly>	<isAffiliatedTo>	<Cambridge_United_F.C.>	<Iran>
<Dean_Hammond>	<isAffiliatedTo>	<Colchester_United_F.C.>	<Scotland>
<Chris_Withe>	<wasBornIn>	<Liverpool>	<England>
<Elizabeth_Taylor>	<isMarriedTo>	<Richard_Burton>	<England>
<Rachel_Portman>	<wroteMusicFor>	<Beloved_(film)>	<Italy>
<Sri_Lanka>	<isLocatedIn>	<Indian_Ocean>	<Belgium>
<Sophia_Loren>	<livesIn>	<Switzerland>	<Norway>
<Parlophone>	<isLocatedIn>	<United_Kingdom>	<Niger>
<Diego_Perrone>	<isAffiliatedTo>	<Club_Olimpia>	<Panama>
<Danny_Granville>	<isAffiliatedTo>	<Norwich_City_F.C.>	<Slovenia>
<Patrick_McGoohan>	<actedIn>	<The_Phantom_(1996_film)>	<Belgium>
<Weber_State_University>	<isLocatedIn>	<Utah>	<Martinique>
<Stuart_Cash>	<playsFor>	<Wycombe_Wanderers_F.C.>	<Germany>
<Tim_Carter_(footballer)>	<isAffiliatedTo>	<Millwall_F.C.>	<England>
<Nobel_Prize_in_Physiology_or_Medicine>	<isLocatedIn>	<Stockholm>	<Canada>
<Antonio_Banderas>	<actedIn>	<Four_Rooms>	<Mali>
<Charles_Darwin>	<worksAt>	<University_of_Cambridge>	<Sweden>
<Scott_Barrett_(footballer)>	<isAffiliatedTo>	<Gillingham_F.C.>	<Cyprus>
<Emerson_(footballer,_born_1976)>	<isAffiliatedTo>	<Brazil_national_football_team>	<Democratic_Republic_of_the_Congo>
<Éder_(Italian_footballer)>	<isAffiliatedTo>	<A.C._Cesena>	<United_States>
<Kumasi>	<isLocatedIn>	<Ghana>	<England>
<Gregg_Wylde>	<isAffiliatedTo>	<Celtic_F.C.>	<Russia>
<Jack_Reynolds_(footballer,_born_1869)>	<playsFor>	<Aston_Villa_F.C.>	<Belgium>
<EasyJet>	<isLocatedIn>	<Barcelona–El_Prat_Airport>	<United_Kingdom>
<Bobby_Mimms>	<isAffiliatedTo>	<Rotherham_United_F.C.>	<Netherlands>
<Legend_(1985_film)>	<isLocatedIn>	<United_Kingdom>	<Sweden>
<Neil_Warnock>	<isAffiliatedTo>	<Barnsley_F.C.>	<Italy>
<Milwaukee_County,_Wisconsin>	<isLocatedIn>	<Milwaukee>	<Mali>
<Kingston_upon_Hull>	<isLocatedIn>	<East_Riding_of_Yorkshire>	<Hungary>
<Ginger_Rogers>	<wasBornIn>	<Independence,_Missouri>	<Kazakhstan>
<Salma_Hayek>	<actedIn>	<Puss_in_Boots_(2011_film)>	<Cyprus>
<War_of_1812>	<happenedIn>	<North_America>	<Northern_Ireland>
<Peru>	<dealsWith>	<China>	<Netherlands>
<Sid_Binks>	<playsFor>	<Chesterfield_F.C.>	<Monaco>
<Djibril_Cissé>	<isAffiliatedTo>	<S.S._Lazio>	<Nigeria>
<Bon_Jovi>	<hasWonPrize>	<World_Music_Awards>	<England>
<Hancock_(film)>	<isLocatedIn>	<United_States>	<Italy>
<Mark_Hamill>	<actedIn>	<Star_Wars_Holiday_Special>	<India>
<Coimbatore>	<isLocatedIn>	<Coimbatore_district>	<Germany>
<Clive_Barker>	<influences>	<Alan_Moore>	<France>
<Bolt_(2008_film)>	<isLocatedIn>	<United_States>	<Japan>
<Danny_Maddix>	<isAffiliatedTo>	<Grays_Athletic_F.C.>	<Niger>
<Peter_Dougall>	<playsFor>	<Burnley_F.C.>	<China>
<Simon_Whaley>	<isAffiliatedTo>	<Chesterfield_F.C.>	<Belgium>
<Peter_Meehan>	<playsFor>	<Sunderland_A.F.C.>	<Dominica>
<Edward_Norton>	<actedIn>	<The_Illusionist_(2006_film)>	<China>
<Battle_of_France>	<happenedIn>	<Netherlands>	<Barbados>
<Devin_Townsend>	<wasBornIn>	<New_Westminster>	<Puerto_Rico>
<George_Carlin>	<influences>	<Whoopi_Goldberg>	<Israel>
<Eli_Wallach>	<actedIn>	<The_Holiday>	<Hungary>
<Brad_Jones_(footballer)>	<playsFor>	<Bradford_City_A.F.C.>	<Nigeria>
<Marcus_Haber>	<isAffiliatedTo>	<Crewe_Alexandra_F.C.>	<Bulgaria>
<Ashley_Grimes_(footballer,_born_1957)>	<isAffiliatedTo>	<Luton_Town_F.C.>	<China>
<Paul_Rideout>	<playsFor>	<Swindon_Town_F.C.>	<Mali>
<Bob_Curry>	<isAffiliatedTo>	<Leeds_United_F.C.>	<Switzerland>
<Luftwaffe>	<isLocatedIn>	<Nazi_Germany>	<Northern_Ireland>
<Ben_Affleck>	<actedIn>	<Dogma_(film)>	<Dominica>
<Craig_Davies_(footballer)>	<isAffiliatedTo>	<Brighton_&_Hove_Albion_F.C.>	<Argentina>
<Mike_Stowell>	<playsFor>	<Preston_North_End_F.C.>	<Belgium>
<Alejandro_Scopelli>	<isAffiliatedTo>	<C.F._Os_Belenenses>	<Norway>
<Peter_Skipper>	<isAffiliatedTo>	<Scunthorpe_United_F.C.>	<France>
<Ronnie_Wallwork>	<isAffiliatedTo>	<Manchester_United_F.C.>	<Tanzania>
<British_Columbia>	<isLocatedIn>	<Vancouver>	<Israel>
<The_Rainmaker_(1997_film)>	<isLocatedIn>	<Germany>	<Greece>
<Bradley_Thomas_(footballer)>	<isAffiliatedTo>	<Crawley_Town_F.C.>	<England>
<Lindsay_Lohan>	<actedIn>	<I_Know_Who_Killed_Me>	<Canada>
<Alex_Taylor_(footballer)>	<playsFor>	<Partick_Thistle_F.C.>	<Nigeria>
<Isaiah_Washington>	<wasBornIn>	<Houston>	<Bangladesh>
<New_Brunswick>	<hasCapital>	<Fredericton>	<Puerto_Rico>
<Geoff_Thomas_(footballer,_born_1964)>	<isAffiliatedTo>	<Crewe_Alexandra_F.C.>	<Serbia>
<Paul_Marshall_(footballer)>	<isAffiliatedTo>	<Aberdeen_F.C.>	<Democratic_Republic_of_the_Congo>
<Walon_Green>	<hasWonPrize>	<Edgar_Award>	<Belgium>
<Latvia>	<hasNeighbor>	<Lithuania>	<Puerto_Rico>
<United_States>	<participatedIn>	<Operation_Serval>	<Bangladesh>
<Darren_Byfield>	<isAffiliatedTo>	<Bristol_City_F.C.>	<Hungary>
<Andy_Keogh>	<isAffiliatedTo>	<Leeds_United_F.C.>	<Senegal>
<Bob_Fosse>	<directed>	<All_That_Jazz_(film)>	<Puerto_Rico>
<Koei_Tecmo>	<isLocatedIn>	<Kanagawa_Prefecture>	<Senegal>
<Invercargill>	<isLocatedIn>	<South_Island>	<Bahrain>
<Peter_Ustinov>	<actedIn>	<Quo_Vadis_(1951_film)>	<India>
<Ryan_Brunt_(footballer)>	<isAffiliatedTo>	<Plymouth_Argyle_F.C.>	<Panama>
<Myles_Weston>	<isAffiliatedTo>	<Charlton_Athletic_F.C.>	<Austria>
<Gary_McSheffrey>	<isAffiliatedTo>	<Birmingham_City_F.C.>	<Republic_of_the_Congo>
<Kevin_McCarthy_(actor)>	<graduatedFrom>	<University_of_Minnesota>	<Brazil>
<Kevin_Dearden>	<playsFor>	<Brentford_F.C.>	<Wales>
<Al_Green>	<livesIn>	<Memphis,_Tennessee>	<Iran>
<Chris_Arthur>	<playsFor>	<AFC_Wimbledon>	<Bulgaria>
<Sacha_Opinel>	<isAffiliatedTo>	<Leyton_Orient_F.C.>	<Serbia>
<Joleon_Lescott>	<wasBornIn>	<Birmingham>	<Iran>
<Los_Angeles_International_Airport>	<isLocatedIn>	<Greater_Los_Angeles_Area>	<Kazakhstan>
<Ryan_Brunt_(footballer)>	<isAffiliatedTo>	<Tranmere_Rovers_F.C.>	<Panama>
<Simon_Cziommer>	<isAffiliatedTo>	<FC_Utrecht>	<United_States>
<Mark_Farrington>	<isAffiliatedTo>	<Hereford_United_F.C.>	<India>
<Tom_Heaton>	<isAffiliatedTo>	<Burnley_F.C.>	<Russia>
<Peter_Barnes_(footballer)>	<isAffiliatedTo>	<Hull_City_A.F.C.>	<Israel>
<Danny_Elfman>	<wroteMusicFor>	<Restless_(2011_film)>	<Bangladesh>
<East_Asia>	<isLocatedIn>	<Guangzhou>	<Serbia>
<Jon_Macken>	<isAffiliatedTo>	<Preston_North_End_F.C.>	<Tanzania>
<Jerry_Siegel>	<wasBornIn>	<Cleveland>	<Kazakhstan>
<James_Ingram>	<wasBornIn>	<Akron,_Ohio>	<Croatia>
<Shirley_MacLaine>	<actedIn>	<Around_the_World_in_80_Days_(1956_film)>	<Monaco>
<Peter_Kyle>	<isAffiliatedTo>	<Leicester_City_F.C.>	<Italy>
<Danube>	<isLocatedIn>	<Croatia>	<El_Salvador>
<Marvel_Entertainment>	<owns>	<Marvel_Comics>	<Nigeria>
<Tony_Cottee>	<isAffiliatedTo>	<England_national_football_team>	<Martinique>
<Columbia_Law_School>	<isLocatedIn>	<New_York>	<Barbados>
<Ottoman_Empire>	<hasOfficialLanguage>	<Turkish_language>	<Niger>
<Inyo_County,_California>	<isLocatedIn>	<California>	<Cameroon>
<Gavin_Hoyte>	<isAffiliatedTo>	<Arsenal_F.C.>	<Poland>
<Kenny_Cooper>	<wasBornIn>	<Baltimore>	<Germany>
<Juan_Esnáider>	<isAffiliatedTo>	<Argentina_national_football_team>	<Puerto_Rico>
<Paul_Evans_(footballer,_born_1974)>	<isAffiliatedTo>	<Swindon_Town_F.C.>	<Democratic_Republic_of_the_Congo>
<Tajikistan>	<dealsWith>	<Switzerland>	<Democratic_Republic_of_the_Congo>
<Kevin_Spacey>	<actedIn>	<L.A._Confidential_(film)>	<China>
<Wayne_Gray_(footballer)>	<isAffiliatedTo>	<Grays_Athletic_F.C.>	<Denmark>
<Jérôme_Leroy_(footballer)>	<isAffiliatedTo>	<Le_Havre_AC>	<Canada>
<Wayne_Brown_(footballer,_born_August_1977)>	<isAffiliatedTo>	<Gillingham_F.C.>	<Republic_of_Ireland>
<Rebecca_Hall>	<actedIn>	<Starter_for_10_(film)>	<Bulgaria>
<Kei_Kamara>	<isAffiliatedTo>	<Sierra_Leone_national_football_team>	<Serbia>
<Modibo_Diakité>	<isAffiliatedTo>	<Frosinone_Calcio>	<Bahrain>
<Daniel_Kearns_(footballer)>	<isAffiliatedTo>	<West_Ham_United_F.C.>	<Northern_Ireland>
<Ben_Roberts_(footballer)>	<isAffiliatedTo>	<Hartlepool_United_F.C.>	<Monaco>
<Ravi_Shankar>	<wroteMusicFor>	<Gandhi_(film)>	<Slovenia>
<Georgi_Donkov>	<isAffiliatedTo>	<VfL_Bochum>	<Australia>
<Michael_Cera>	<actedIn>	<Scott_Pilgrim_vs._the_World>	<Chile>
<Federico_Fellini>	<directed>	<La_Dolce_Vita>	<Sweden>
<Michael_Bridges>	<isAffiliatedTo>	<Sunderland_A.F.C.>	<Martinique>
<Ludwig_Wittgenstein>	<diedIn>	<Cambridge>	<Nigeria>
<Steven_Tyler>	<hasChild>	<Liv_Tyler>	<El_Salvador>
<Kelvin_Langmead>	<isAffiliatedTo>	<Preston_North_End_F.C.>	<Cameroon>
<Jimmy_Fallon>	<hasWonPrize>	<Grammy_Award>	<Russia>
<Uche_Ikpeazu>	<isAffiliatedTo>	<Reading_F.C.>	<Northern_Ireland>
<James_Dunne>	<isAffiliatedTo>	<Wimbledon_F.C.>	<Panama>
<Richie_Foran>	<playsFor>	<Shelbourne_F.C.>	<France>
<Assassins_(film)>	<isLocatedIn>	<United_States>	<Iran>
<Hillsborough_County,_New_Hampshire>	<isLocatedIn>	<Nashua,_New_Hampshire>	<Argentina>
<Bob_Ludwig>	<hasWonPrize>	<Grammy_Award>	<Denmark>
<Kamloops>	<isLocatedIn>	<British_Columbia>	<Bangladesh>
<Cássio_Oliveira>	<isAffiliatedTo>	<Club_Olimpia>	<Brazil>
<Pat_Terry>	<isAffiliatedTo>	<Northampton_Town_F.C.>	<Russia>
<Wayne_Biggins>	<isAffiliatedTo>	<Stoke_City_F.C.>	<Germany>
<FC_Zenit_Saint_Petersburg>	<isLocatedIn>	<Russia>	<Wales>
<Albert_Holmes_(footballer,_born_1885)>	<playsFor>	<Coventry_City_F.C.>	<Brazil>
<Liam_Chilvers>	<playsFor>	<A.F.C._Telford_United>	<Germany>
<James_Tavernier>	<isAffiliatedTo>	<Sheffield_Wednesday_F.C.>	<Italy>
<Billy_Manuel>	<isAffiliatedTo>	<Grays_Athletic_F.C.>	<Argentina>
<Chicago>	<isLocatedIn>	<Chicago_metropolitan_area>	<Nigeria>
<Neil_Simon>	<created>	<The_Goodbye_Girl>	<Iran>
<Viggo_Mortensen>	<actedIn>	<Psycho_(1998_film)>	<Republic_of_the_Congo>
<Lee_Chapman>	<playsFor>	<Southend_United_F.C.>	<Italy>
<Brian_Rice_(footballer)>	<isAffiliatedTo>	<Nottingham_Forest_F.C.>	<Cameroon>
<Manny_Panther>	<isAffiliatedTo>	<Partick_Thistle_F.C.>	<Serbia>
<Lauren_Bacall>	<actedIn>	<The_Mirror_Has_Two_Faces>	<Poland>
<Chris_Hackett_(footballer)>	<isAffiliatedTo>	<Heart_of_Midlothian_F.C.>	<Panama>
<Italy>	<participatedIn>	<Lebanese_Civil_War>	<France>
<Anaheim,_California>	<isLocatedIn>	<California>	<Monaco>
<Wuhan>	<isLocatedIn>	<China>	<Brazil>
<Alex_Cisak>	<isAffiliatedTo>	<Leyton_Orient_F.C.>	<Switzerland>
<Lilian_Nalis>	<playsFor>	<Plymouth_Argyle_F.C.>	<China>
<Kim_Grant_(footballer)>	<isAffiliatedTo>	<Luton_Town_F.C.>	<Senegal>
<Ryan_Burge>	<isAffiliatedTo>	<Birmingham_City_F.C.>	<Brazil>
<K.A.A._Gent>	<isLocatedIn>	<Ghent>	<Republic_of_Ireland>
<Peter_Stone>	<hasWonPrize>	<Emmy_Award>	<Panama>
<Warner_Bros._Animation>	<isLocatedIn>	<California>	<Northern_Ireland>
<Ed_O'Neill>	<actedIn>	<The_Adventures_of_Ford_Fairlane>	<Kazakhstan>
<Alfred_Molina>	<actedIn>	<Magnolia_(film)>	<Iran>
<Jeffrey_Jones>	<wasBornIn>	<Buffalo,_New_York>	<Slovenia>
<Giuseppe_Greco_(footballer,_born_1983)>	<isAffiliatedTo>	<U.C._Sampdoria>	<Hungary>
<Diane_Lane>	<actedIn>	<Casting_By>	<Greece>
<Uma_Thurman>	<actedIn>	<The_Avengers_(1998_film)>	<Scotland>
<Guy_Branston>	<isAffiliatedTo>	<Rotherham_United_F.C.>	<Chile>
<Andy_Todd_(footballer,_born_1974)>	<isAffiliatedTo>	<Oldham_Athletic_A.F.C.>	<Germany>
<Tony_Scully>	<isAffiliatedTo>	<Manchester_City_F.C.>	<Denmark>
<Andrew_Hughes_(footballer,_born_1978)>	<isAffiliatedTo>	<Charlton_Athletic_F.C.>	<India>
<Nora_Ephron>	<created>	<Julie_&_Julia>	<Ukraine>
<John_Rowlands_(footballer)>	<isAffiliatedTo>	<Crewe_Alexandra_F.C.>	<Hungary>
<Phil_Spector>	<wasBornIn>	<The_Bronx>	<Cyprus>
<Kingdom_of_Romania>	<participatedIn>	<Operation_Barbarossa>	<Chile>
<Paul_Butler_(footballer,_born_1972)>	<isAffiliatedTo>	<Milton_Keynes_Dons_F.C.>	<Scotland>
<Charles_Rosher>	<diedIn>	<Lisbon>	<Switzerland>
<Chris_Pronger>	<isAffiliatedTo>	<Edmonton_Oilers>	<Canada>
<Van_Johnson>	<actedIn>	<The_Caine_Mutiny_(film)>	<Hungary>
<Anthony_Pulis>	<playsFor>	<Aldershot_Town_F.C.>	<Australia>
<Colm_Feore>	<actedIn>	<Pearl_Harbor_(film)>	<Poland>
<Clint_Eastwood>	<directed>	<Hereafter_(film)>	<Russia>
<Vera_Drake>	<isLocatedIn>	<France>	<Brazil>
<Adam_Virgo>	<isAffiliatedTo>	<Bristol_Rovers_F.C.>	<Brazil>
<Turkey>	<dealsWith>	<Iraq>	<Denmark>
<Tomislav_Ivić>	<isAffiliatedTo>	<HNK_Hajduk_Split>	<France>
<Cristiano_Lucarelli>	<isAffiliatedTo>	<Italy_national_football_team>	<Sweden>
<Baltimore–Washington_metropolitan_area>	<isLocatedIn>	<Towson,_Maryland>	<Tanzania>
<Stephen_Warnock>	<playsFor>	<Aston_Villa_F.C.>	<Senegal>
<Lee_Morris_(footballer)>	<isAffiliatedTo>	<Hereford_United_F.C.>	<Bahrain>
<Tommy_Tynan>	<isAffiliatedTo>	<Sheffield_Wednesday_F.C.>	<Canada>
<Mel_Brooks>	<hasWonPrize>	<Grammy_Award>	<Italy>
<Matt_Elliott_(footballer)>	<isAffiliatedTo>	<Leicester_City_F.C.>	<Martinique>
<Anthony_Hopkins>	<actedIn>	<Thor_(film)>	<Bulgaria>
<Courtney_Pitt>	<wasBornIn>	<Paddington>	<Bahrain>
<Gavin_Mahon>	<playsFor>	<Hereford_United_F.C.>	<Dominica>
<Arkansas>	<isLocatedIn>	<United_States>	<Bangladesh>
<James_Horner>	<created>	<Willow_(film)>	<Senegal>
<Nicolas_Cage>	<actedIn>	<Moonstruck>	<Greece>
<Copenhagen>	<isLocatedIn>	<Denmark>	<Austria>
<John_Roberts_(footballer,_born_1946)>	<isAffiliatedTo>	<Arsenal_F.C.>	<India>
<Duncan_McKenzie>	<isAffiliatedTo>	<Everton_F.C.>	<Cape_Verde>
<George_Hamilton_(actor)>	<actedIn>	<The_Godfather_Part_III>	<Mali>
<Andy_Petterson>	<playsFor>	<Southend_United_F.C.>	<Democratic_Republic_of_the_Congo>
<St._Louis_Blues>	<isLocatedIn>	<St._Louis>	<Republic_of_Ireland>
<Tony_Warner>	<playsFor>	<Wellington_Phoenix_FC>	<Bangladesh>
<Wayne_Biggins>	<isAffiliatedTo>	<Oxford_United_F.C.>	<Germany>
<Robert_Earnshaw>	<playsFor>	<Cardiff_City_F.C.>	<Mali>
<Tim_Matheson>	<wasBornIn>	<Glendale,_California>	<Slovenia>
<Pakistan>	<participatedIn>	<Operation_Enduring_Freedom_–_Horn_of_Africa>	<India>
<Michael_Spies>	<wasBornIn>	<Stuttgart>	<Greece>
<Los_Lobos>	<wroteMusicFor>	<Spy_Kids>	<Italy>
<63rd_Academy_Awards>	<happenedIn>	<California>	<Iran>
<White_Plains,_New_York>	<isLocatedIn>	<New_York>	<Ukraine>
<49th_Annual_Grammy_Awards>	<isLocatedIn>	<Los_Angeles>	<Senegal>
<Geoff_Horsfield>	<isAffiliatedTo>	<Leicester_City_F.C.>	<Israel>
<Sam_Russell_(footballer,_born_1982)>	<isAffiliatedTo>	<Darlington_F.C.>	<Mali>
<James_Woods>	<actedIn>	<Once_Upon_a_Time_in_America>	<Cameroon>
<Julian_Joachim>	<isAffiliatedTo>	<Coventry_City_F.C.>	<Bangladesh>
<State_of_Mexico>	<isLocatedIn>	<Mexico>	<Hungary>
<Allan_Holdsworth>	<wasBornIn>	<Bradford>	<Ukraine>
<Zoran_Rajović>	<isAffiliatedTo>	<FK_Vojvodina>	<Israel>
<Mike_Nichols>	<isMarriedTo>	<Diane_Sawyer>	<Nigeria>
<Trevor_Aylott>	<playsFor>	<Wycombe_Wanderers_F.C.>	<Jamaica>
<Dominic_Blizzard>	<isAffiliatedTo>	<Plymouth_Argyle_F.C.>	<Kazakhstan>
<Anthony_Hopkins>	<actedIn>	<Alexander_(2004_film)>	<Bulgaria>
<Winnipeg>	<isLocatedIn>	<Canada>	<Bahrain>
<Clint_Eastwood>	<directed>	<Million_Dollar_Baby>	<Russia>
<Warren_Aspinall>	<isAffiliatedTo>	<Swansea_City_A.F.C.>	<Slovenia>
<Steve_Taylor_(footballer)>	<isAffiliatedTo>	<Luton_Town_F.C.>	<England>
<Dean_Morgan>	<isAffiliatedTo>	<Luton_Town_F.C.>	<Denmark>
<Ben_Purkiss>	<wasBornIn>	<Sheffield>	<China>
<30_Days_of_Night_(film)>	<isLocatedIn>	<United_States>	<Ukraine>
<Parker_Posey>	<actedIn>	<Best_in_Show_(film)>	<Panama>
<Alexander_Hleb>	<isAffiliatedTo>	<FC_Barcelona>	<Jamaica>
<Harry_Belafonte>	<hasWonPrize>	<Jean_Hersholt_Humanitarian_Award>	<Switzerland>
<Martin_Short>	<hasWonPrize>	<Tony_Award>	<El_Salvador>
<Yale_Divinity_School>	<isLocatedIn>	<New_Haven,_Connecticut>	<Chile>
<Rick_Rubin>	<created>	<Def_Jam_Recordings>	<Iran>
<Liam_George>	<playsFor>	<Bury_F.C.>	<Bangladesh>
<Lomana_LuaLua>	<isAffiliatedTo>	<Portsmouth_F.C.>	<England>
<Peter_Berg>	<created>	<Friday_Night_Lights_(TV_series)>	<Croatia>
<Kuwait>	<participatedIn>	<Gulf_War>	<Spain>
<Neil_Ross>	<livesIn>	<Los_Angeles>	<Tanzania>
<Austria-Hungary>	<participatedIn>	<Settling_Accounts>	<France>
<Lloyd_Opara>	<playsFor>	<Peterborough_United_F.C.>	<Puerto_Rico>
<Bulawayo>	<isLocatedIn>	<Zimbabwe>	<Russia>
<Algeria>	<isLocatedIn>	<Africa>	<Cape_Verde>
<Patricia_Arquette>	<actedIn>	<Lost_Highway_(film)>	<Norway>
<Toumani_Diagouraga>	<wasBornIn>	<Paris>	<Slovenia>
<11Eleven_Project>	<isLocatedIn>	<Philippines>	<Israel>
<Artie_Lange>	<wasBornIn>	<Livingston,_New_Jersey>	<Bahrain>
<Iain_Turner>	<isAffiliatedTo>	<Everton_F.C.>	<Croatia>
<Bondz_N'Gala>	<isAffiliatedTo>	<Yeovil_Town_F.C.>	<Greece>
<Craig_Allardyce>	<isAffiliatedTo>	<Blackpool_F.C.>	<Cameroon>
<Malaysia>	<participatedIn>	<United_Nations_Operation_in_Somalia_II>	<Italy>
<James_Mason>	<actedIn>	<Julius_Caesar_(1953_film)>	<Poland>
<Marco_Baroni>	<isAffiliatedTo>	<Udinese_Calcio>	<Panama>
<Carl_Dickinson>	<playsFor>	<Watford_F.C.>	<Canada>
<Richard_Sylbert>	<wasBornIn>	<Brooklyn>	<Barbados>
<Gertrude_Stein>	<diedIn>	<Neuilly-sur-Seine>	<Iran>
<Ballet_Shoes_(film)>	<isLocatedIn>	<United_Kingdom>	<Wales>
<KV_Mechelen>	<hasWonPrize>	<Nobel_Prize_in_Physiology_or_Medicine>	<France>
<Fergie_(singer)>	<actedIn>	<Nine_(2009_live-action_film)>	<Ukraine>
<James_Dunne>	<isAffiliatedTo>	<Nottingham_Forest_F.C.>	<Panama>
<Grand_Rapids,_Michigan>	<isLocatedIn>	<Michigan>	<Mali>
<John_Hendry_(footballer)>	<isAffiliatedTo>	<Swansea_City_A.F.C.>	<Kazakhstan>
<Anatole_Litvak>	<diedIn>	<Neuilly-sur-Seine>	<Croatia>
<Howard_Shore>	<wroteMusicFor>	<The_Lord_of_the_Rings_(film_series)>	<Scotland>
<Maggie_Smith>	<hasWonPrize>	<Tony_Award>	<China>
<Burt_Lancaster>	<hasWonPrize>	<Venice_Film_Festival>	<England>
<John_Barnes_(footballer)>	<isAffiliatedTo>	<Watford_F.C.>	<United_States>
<Richard_Pryor>	<influences>	<Whoopi_Goldberg>	<Monaco>
<Nathan_Fillion>	<actedIn>	<Super_(2010_American_film)>	<El_Salvador>
<Justin_Chambers>	<wasBornIn>	<Springfield,_Ohio>	<Ukraine>
<Brian_Jackson_(footballer,_born_1933)>	<isAffiliatedTo>	<Burton_Albion_F.C.>	<Bangladesh>
<Billy_Hendry>	<isAffiliatedTo>	<Kidderminster_Harriers_F.C.>	<Bulgaria>
<Sam_Togwell>	<isAffiliatedTo>	<Barnet_F.C.>	<Bangladesh>
<Chris_Crowe>	<wasBornIn>	<Newcastle_upon_Tyne>	<Russia>
<FC_Basel>	<isLocatedIn>	<Basel>	<Panama>
<Martin_Woods>	<isAffiliatedTo>	<Doncaster_Rovers_F.C.>	<Belgium>
<Raïs_M'Bolhi>	<wasBornIn>	<Paris>	<Israel>
<Jonson_Clarke-Harris>	<isAffiliatedTo>	<Peterborough_United_F.C.>	<Norway>
<Matthew_Barnes-Homer>	<playsFor>	<Kidderminster_Harriers_F.C.>	<Bangladesh>
<Clint_Hill_(footballer)>	<playsFor>	<Queens_Park_Rangers_F.C.>	<Australia>
<Joe_Johnson_(footballer,_born_1911)>	<wasBornIn>	<Grimsby>	<Russia>
<Jon_Beswetherick>	<isAffiliatedTo>	<Kidderminster_Harriers_F.C.>	<Greece>
<Jimmy_Spencer_(footballer)>	<isAffiliatedTo>	<Cambridge_United_F.C.>	<Wales>
<Mark_Wilson_(English_footballer)>	<playsFor>	<Walsall_F.C.>	<Serbia>
<Arthur_Beadsworth>	<playsFor>	<Blackburn_Rovers_F.C.>	<Democratic_Republic_of_the_Congo>
<Nintendo_World_Championships>	<isLocatedIn>	<Cleveland>	<Senegal>
<Edmund_Husserl>	<graduatedFrom>	<Leipzig_University>	<Wales>
<Billy_Knott>	<isAffiliatedTo>	<Port_Vale_F.C.>	<Tanzania>
<Richard_O'Donnell>	<isAffiliatedTo>	<Chesterfield_F.C.>	<Panama>
<Graham_Potter>	<playsFor>	<West_Bromwich_Albion_F.C.>	<Belgium>
<Simeon_Hodson>	<playsFor>	<Altrincham_F.C.>	<Barbados>
<Steve_Torpey_(footballer,_born_1970)>	<isAffiliatedTo>	<Scunthorpe_United_F.C.>	<Switzerland>
<Gary_Mulligan>	<isAffiliatedTo>	<Gillingham_F.C.>	<Barbados>
<Sofia_Coppola>	<hasWonPrize>	<Independent_Spirit_Award_for_Best_Director>	<Austria>
<Jonatan_Johansson_(footballer)>	<isAffiliatedTo>	<Norwich_City_F.C.>	<United_States>
<Bob_Curry>	<isAffiliatedTo>	<Colchester_United_F.C.>	<Switzerland>
<Ventura,_California>	<isLocatedIn>	<United_States>	<Mali>
<Blackpool>	<isLocatedIn>	<North_West_England>	<Ukraine>
<Bertie_Brayley>	<isAffiliatedTo>	<Swindon_Town_F.C.>	<Belgium>
<Vanderlei_Luxemburgo>	<isAffiliatedTo>	<Real_Madrid_C.F.>	<China>
<Alan_Silvestri>	<wroteMusicFor>	<Back_to_the_Future_Part_III>	<Barbados>
<Damon_Lindelof>	<wasBornIn>	<Teaneck,_New_Jersey>	<Scotland>
<Greater_Sudbury>	<isLocatedIn>	<Ontario>	<Austria>
<Epsom>	<isLocatedIn>	<Surrey>	<Switzerland>
<Serbia>	<dealsWith>	<Italy>	<Cape_Verde>
<Craig_McAllister>	<isAffiliatedTo>	<Luton_Town_F.C.>	<Kazakhstan>
<James_Rebhorn>	<actedIn>	<The_Adventures_of_Pluto_Nash>	<Croatia>
<Tom_Cowan>	<isAffiliatedTo>	<Huddersfield_Town_A.F.C.>	<Cyprus>
<XXX_(2002_film)>	<isLocatedIn>	<United_States>	<Australia>
<Jane_Espenson>	<wasBornIn>	<Ames,_Iowa>	<Austria>
<Daniel_Inouye>	<wasBornIn>	<Honolulu>	<Northern_Ireland>
<George_Carlin>	<wasBornIn>	<New_York_City>	<Israel>
<Pamela_Adlon>	<hasWonPrize>	<Primetime_Emmy_Award>	<Austria>
<Noel_Whelan_(footballer)>	<playsFor>	<Harrogate_Town_F.C.>	<Northern_Ireland>
<Ben_Hamer>	<isAffiliatedTo>	<Bristol_City_F.C.>	<Hungary>
<Sierra_Entertainment>	<isLocatedIn>	<Fresno,_California>	<Germany>
<Lake_Erie>	<isLocatedIn>	<Erie,_Pennsylvania>	<Bulgaria>
<Nick_Pope_(footballer)>	<isAffiliatedTo>	<Welling_United_F.C.>	<Switzerland>
<Massachusetts>	<isLocatedIn>	<United_States>	<Barbados>
<Van_Nuys>	<isLocatedIn>	<California>	<Australia>
<Sangamon_County,_Illinois>	<isLocatedIn>	<Illinois>	<Russia>
<Barry_Robson>	<isAffiliatedTo>	<Middlesbrough_F.C.>	<Kazakhstan>
<Adrian_Littlejohn>	<isAffiliatedTo>	<Walsall_F.C.>	<Hungary>
<Abel_Xavier>	<playsFor>	<Everton_F.C.>	<Monaco>
<Mark_Wilson_(English_footballer)>	<playsFor>	<Tranmere_Rovers_F.C.>	<Serbia>
<Armenia>	<dealsWith>	<Turkey>	<Tanzania>
<46th_Academy_Awards>	<happenedIn>	<Dorothy_Chandler_Pavilion>	<Sweden>
<Pennine_Alps>	<isLocatedIn>	<Piedmont>	<Argentina>
<Rafik_Djebbour>	<isAffiliatedTo>	<Panionios_F.C.>	<Mali>
<Simon_Colosimo>	<playsFor>	<Manchester_City_F.C.>	<Israel>
<Junichi_Inamoto>	<isAffiliatedTo>	<Eintracht_Frankfurt>	<El_Salvador>
<Sid_Jones>	<isAffiliatedTo>	<Swansea_City_A.F.C.>	<England>
<Shefki_Kuqi>	<playsFor>	<Oldham_Athletic_A.F.C.>	<Germany>
<Long_Turkish_War>	<happenedIn>	<Czech_Republic>	<Senegal>
<Mich>	<isLocatedIn>	<Iran>	<Puerto_Rico>
<Henry_James>	<wasBornIn>	<United_States>	<Democratic_Republic_of_the_Congo>
<New_Bedford,_Massachusetts>	<isLocatedIn>	<Massachusetts>	<Ukraine>
<Himesh_Reshammiya>	<wasBornIn>	<Mumbai>	<Sweden>
<Christian_Hanson_(footballer)>	<wasBornIn>	<Middlesbrough>	<Bulgaria>
<Garry_Chalk>	<livesIn>	<British_Columbia>	<Hungary>
<Graham_Greene_(actor)>	<hasWonPrize>	<Grammy_Award>	<Jamaica>
<Michel_Kuipers>	<wasBornIn>	<Amsterdam>	<England>
<Shane_Lowry_(footballer)>	<wasBornIn>	<Perth>	<Poland>
<Van_Nest_Polglase>	<diedIn>	<Los_Angeles>	<Panama>
<Adam_Rooney>	<isAffiliatedTo>	<Bury_F.C.>	<France>
<Johann_Wolfgang_von_Goethe>	<influences>	<Georg_Wilhelm_Friedrich_Hegel>	<Ukraine>
<Mark_Bowen_(footballer)>	<isAffiliatedTo>	<Stoke_City_F.C.>	<United_States>
<Howard_Gordon>	<hasWonPrize>	<Primetime_Emmy_Award_for_Outstanding_Writing_for_a_Drama_Series>	<Canada>
<Jason_Flemyng>	<actedIn>	<From_Hell_(film)>	<Bahrain>
<Judi_Dench>	<actedIn>	<My_Week_with_Marilyn>	<Martinique>
<Tony_Lormor>	<playsFor>	<Shrewsbury_Town_F.C.>	<Cyprus>
<Reece_Styche>	<playsFor>	<Macclesfield_Town_F.C.>	<Argentina>
<Darko_Bodul>	<isAffiliatedTo>	<SC_Heerenveen>	<Republic_of_the_Congo>
<M._Night_Shyamalan>	<directed>	<The_Last_Airbender>	<Wales>
<Alias_(TV_series)>	<isLocatedIn>	<United_States>	<Martinique>
<Vancouver_Canucks>	<isLocatedIn>	<British_Columbia>	<Poland>
<General_Electric>	<isLocatedIn>	<Fairfield,_Connecticut>	<Serbia>
<Kansas_City,_Missouri>	<isLocatedIn>	<Jackson_County,_Missouri>	<Puerto_Rico>
<Jajá>	<isAffiliatedTo>	<Clube_de_Regatas_do_Flamengo>	<England>
<Patrick_Suffo>	<isAffiliatedTo>	<FC_Barcelona_B>	<Cyprus>
<Bill_Pendergast>	<playsFor>	<Crewe_Alexandra_F.C.>	<Republic_of_Ireland>
<Youssef_El_Akchaoui>	<isAffiliatedTo>	<Morocco_national_football_team>	<Jamaica>
<Peter_Swan_(footballer,_born_1966)>	<isAffiliatedTo>	<Plymouth_Argyle_F.C.>	<Scotland>
<Alan_Lee_(footballer)>	<isAffiliatedTo>	<Rotherham_United_F.C.>	<Poland>
<United_States>	<participatedIn>	<Apache_Wars>	<Bangladesh>
<Laurent_Robert>	<isAffiliatedTo>	<Levante_UD>	<China>
<Leonard_Nimoy>	<actedIn>	<Star_Trek_(film)>	<Jamaica>
<Frank_Worthington>	<isAffiliatedTo>	<Leeds_United_F.C.>	<United_Kingdom>
<Phil_Stant>	<playsFor>	<Dover_Athletic_F.C.>	<Slovenia>
<2017_Romanian_protests>	<happenedIn>	<Cologne>	<El_Salvador>
<Adil_Ramzi>	<playsFor>	<AZ_Alkmaar>	<Northern_Ireland>
<Des_Lyttle>	<isAffiliatedTo>	<West_Bromwich_Albion_F.C.>	<India>
<Gary_Shelton>	<isAffiliatedTo>	<Walsall_F.C.>	<Cameroon>
<Cristian_Montaño>	<isAffiliatedTo>	<Oldham_Athletic_A.F.C.>	<Mali>
<Carlos_Bocanegra>	<isAffiliatedTo>	<Rangers_F.C.>	<Niger>
<Stewart_Littlewood>	<isAffiliatedTo>	<Oldham_Athletic_A.F.C.>	<Chile>
<Carlton_Cuse>	<wasBornIn>	<Mexico_City>	<Chile>
<11Eleven_Project>	<isLocatedIn>	<United_States>	<Israel>
<Carole_Lombard>	<isMarriedTo>	<Clark_Gable>	<Chile>
<Daniel_Nardiello>	<isAffiliatedTo>	<Bury_F.C.>	<Martinique>
<Dave_Martin_(footballer,_born_1963)>	<isAffiliatedTo>	<Leyton_Orient_F.C.>	<Switzerland>
<Julian_Alsop>	<playsFor>	<Northampton_Town_F.C.>	<France>
<Toho>	<isLocatedIn>	<Chiyoda,_Tokyo>	<United_States>
<Frederick_Mearns>	<isAffiliatedTo>	<Grays_Athletic_F.C.>	<Puerto_Rico>
<Mike_Marsh_(footballer)>	<isAffiliatedTo>	<Galatasaray_S.K._(football)>	<Israel>
<Grand_Teton_National_Park>	<isLocatedIn>	<United_States>	<Austria>
<Aruna_Irani>	<wasBornIn>	<Mumbai>	<Nigeria>
<Edmonton_Eskimos>	<isLocatedIn>	<Edmonton>	<Brazil>
<Mario_Bortolazzi>	<isAffiliatedTo>	<Hellas_Verona_F.C.>	<Northern_Ireland>
<Columbia_University_Graduate_School_of_Journalism>	<isLocatedIn>	<Manhattan>	<Japan>
<O'Neill_Donaldson>	<isAffiliatedTo>	<Mansfield_Town_F.C.>	<Norway>
<Wikimedia_Foundation>	<isLocatedIn>	<Los_Angeles>	<Ukraine>
<Meryl_Streep>	<actedIn>	<Fantastic_Mr._Fox_(film)>	<Scotland>
<Steve_Guinan>	<isAffiliatedTo>	<Shrewsbury_Town_F.C.>	<Argentina>
<New_Zealand>	<dealsWith>	<Germany>	<United_States>
<Denver_Nuggets>	<isLocatedIn>	<Denver>	<Serbia>
<Mickaël_Antoine-Curier>	<playsFor>	<Oldham_Athletic_A.F.C.>	<United_States>
<Claude_Davis>	<isAffiliatedTo>	<Derby_County_F.C.>	<Bulgaria>
<Brent_Sancho>	<isAffiliatedTo>	<Portland_Timbers>	<Sweden>
<Sydney_Pollack>	<directed>	<The_Firm_(1993_film)>	<United_Kingdom>
<Arthur_Sharp_(footballer)>	<playsFor>	<Reading_F.C.>	<Kazakhstan>
<Jason_Kidd>	<isAffiliatedTo>	<Phoenix_Suns>	<Bangladesh>
<Scott_Canham>	<isAffiliatedTo>	<West_Ham_United_F.C.>	<Wales>
<Keith_Rowland>	<isAffiliatedTo>	<Coventry_City_F.C.>	<Germany>
<Santa_Monica,_California>	<isLocatedIn>	<Los_Angeles_County,_California>	<Jamaica>
<Fraizer_Campbell>	<isAffiliatedTo>	<Hull_City_A.F.C.>	<England>
<Andy_Kennedy_(footballer,_born_1964)>	<isAffiliatedTo>	<Sheffield_United_F.C.>	<Croatia>
<Cape_May_County,_New_Jersey>	<isLocatedIn>	<New_Jersey>	<Germany>
<Craig_Ireland>	<playsFor>	<Notts_County_F.C.>	<Cameroon>
<George_W._Bush>	<wasBornIn>	<New_Haven,_Connecticut>	<Republic_of_Ireland>
<Pasquale_Foggia>	<playsFor>	<A.C._Milan>	<Netherlands>
<Alphonse_Tchami>	<isAffiliatedTo>	<Odense_Boldklub>	<Greece>
<Saša_Ilić_(footballer,_born_1972)>	<isAffiliatedTo>	<Portsmouth_F.C.>	<Bangladesh>
<Drenthe>	<isLocatedIn>	<Netherlands>	<Republic_of_Ireland>
<Paolo_Sammarco>	<isAffiliatedTo>	<A.C._ChievoVerona>	<Niger>
<Rod_Steiger>	<actedIn>	<In_the_Heat_of_the_Night_(film)>	<France>
<Dani_Osvaldo>	<playsFor>	<Boca_Juniors>	<Cyprus>
<Paul_Sorvino>	<actedIn>	<Bulworth>	<Japan>
<Harry_Gregson-Williams>	<wroteMusicFor>	<Kingdom_of_Heaven_(film)>	<Brazil>
<David_McCracken>	<isAffiliatedTo>	<Dundee_United_F.C.>	<Martinique>
<Jeff_Whitley>	<playsFor>	<Northwich_Victoria_F.C.>	<Japan>
<József_Viola>	<isAffiliatedTo>	<A.C._Milan>	<Martinique>
<Warren_Feeney>	<isAffiliatedTo>	<Sheffield_Wednesday_F.C.>	<Poland>
<David_Martin_(footballer,_born_1986)>	<isAffiliatedTo>	<Wimbledon_F.C.>	<Cape_Verde>
<Electric_Daisy_Carnival>	<isLocatedIn>	<Las_Vegas>	<Japan>
<Matt_Fish_(footballer)>	<isAffiliatedTo>	<Crystal_Palace_F.C.>	<Martinique>
<Steve_Lovell_(Welsh_footballer)>	<isAffiliatedTo>	<Ebbsfleet_United_F.C.>	<Australia>
<Amari_Morgan-Smith>	<wasBornIn>	<Wolverhampton>	<Northern_Ireland>
<Sylvester_Stallone>	<actedIn>	<Oscar_(1991_film)>	<Chile>
<Steven_Zaillian>	<hasWonPrize>	<Academy_Award_for_Best_Adapted_Screenplay>	<Greece>
<Guy_Branston>	<playsFor>	<Lincoln_City_F.C.>	<Chile>
<Graham_Potter>	<wasBornIn>	<Solihull>	<Belgium>
<Heiner_Backhaus>	<playsFor>	<Olympiakos_Nicosia>	<Croatia>
<Rajasthan>	<isLocatedIn>	<Jaipur>	<Poland>
<Libya>	<hasNeighbor>	<Tunisia>	<Kazakhstan>
<The_Surreal_Life>	<isLocatedIn>	<United_States>	<Republic_of_Ireland>
<Osvaldo_Ardiles>	<isAffiliatedTo>	<GNK_Dinamo_Zagreb>	<Democratic_Republic_of_the_Congo>
<Donna_Summer>	<hasWonPrize>	<Grammy_Award>	<Democratic_Republic_of_the_Congo>
<Roberto_Baronio>	<isAffiliatedTo>	<Udinese_Calcio>	<France>
<Simon_Heslop>	<isAffiliatedTo>	<Northwich_Victoria_F.C.>	<Mali>
<Robert_F._Kennedy>	<graduatedFrom>	<Harvard_University>	<Mali>
<Chris_Palmer_(footballer)>	<isAffiliatedTo>	<Tamworth_F.C.>	<Switzerland>
<John_Moncur>	<isAffiliatedTo>	<West_Ham_United_F.C.>	<Cyprus>
<John_Ford>	<actedIn>	<The_Quiet_Man>	<Switzerland>
<Lee_Peltier>	<wasBornIn>	<Liverpool>	<Spain>
<Klaus_Badelt>	<wroteMusicFor>	<TMNT_(film)>	<Croatia>
<Norman_Mailer>	<actedIn>	<When_We_Were_Kings>	<Panama>
<Intel>	<isLocatedIn>	<California>	<Poland>
<Grégory_Tadé>	<isAffiliatedTo>	<Forfar_Athletic_F.C.>	<Senegal>
<United_Kingdom>	<participatedIn>	<Operation_Enduring_Freedom>	<Bahrain>
<Alex_Rodman>	<isAffiliatedTo>	<Notts_County_F.C.>	<France>
<Scott_Brown_(footballer,_born_April_1985)>	<isAffiliatedTo>	<Eastleigh_F.C.>	<Bahrain>
<Novak_Djokovic>	<livesIn>	<Monaco>	<Tanzania>
<Ray_Haddington>	<isAffiliatedTo>	<A.F.C._Bournemouth>	<Tanzania>
<Jae_Martin>	<isAffiliatedTo>	<Lincoln_City_F.C.>	<Sweden>
<George_Stevens>	<directed>	<A_Place_in_the_Sun_(film)>	<Republic_of_the_Congo>
<The_Walt_Disney_Company>	<owns>	<Disney_Interactive_Studios>	<Croatia>
<Terry_Phelan>	<wasBornIn>	<Manchester>	<United_Arab_Emirates>
<George_McNestry>	<playsFor>	<Sunderland_A.F.C.>	<Brazil>
<Glen_Southam>	<playsFor>	<Eastleigh_F.C.>	<Serbia>
<John_Keeley>	<isAffiliatedTo>	<Chester_City_F.C.>	<Northern_Ireland>
<Graham_Greene_(actor)>	<actedIn>	<The_Green_Mile_(film)>	<Jamaica>
<Bill_Wyman>	<wasBornIn>	<Lewisham>	<Democratic_Republic_of_the_Congo>
<Kazakhstan>	<dealsWith>	<Germany>	<Northern_Ireland>
<Dave_Hanson_(footballer)>	<isAffiliatedTo>	<Welling_United_F.C.>	<El_Salvador>
<Fresno_County,_California>	<isLocatedIn>	<Fresno,_California>	<El_Salvador>
<Andy_O'Brien_(footballer)>	<isAffiliatedTo>	<Bolton_Wanderers_F.C.>	<Ukraine>
<Dean_McDonald>	<playsFor>	<Ipswich_Town_F.C.>	<Norway>
<John_Byrne_(footballer,_born_1939)>	<isAffiliatedTo>	<Barnsley_F.C.>	<Austria>
<Paul_Holsgrove>	<isAffiliatedTo>	<Brighton_&_Hove_Albion_F.C.>	<Dominica>
<Shlomi_Arbeitman>	<isAffiliatedTo>	<Hapoel_Haifa_F.C.>	<Republic_of_Ireland>
<Gavin_Ward_(footballer)>	<playsFor>	<Hednesford_Town_F.C.>	<Serbia>
<Eddie_Albert>	<wasBornIn>	<Rock_Island,_Illinois>	<Israel>
<United_States_Virgin_Islands>	<isLocatedIn>	<United_States>	<Northern_Ireland>
<Keith_Bertschin>	<isAffiliatedTo>	<Birmingham_City_F.C.>	<England>
<Another_Year_(film)>	<isLocatedIn>	<United_Kingdom>	<Slovenia>
<Philippe_Senderos>	<playsFor>	<Rangers_F.C.>	<Greece>
<Guinea-Bissau>	<participatedIn>	<Northern_Mali_conflict>	<Cape_Verde>
<Lateef_Elford-Alliyu>	<playsFor>	<Crawley_Town_F.C.>	<Niger>
<Aaron_Brown_(footballer,_born_1980)>	<playsFor>	<Lincoln_City_F.C.>	<Slovenia>
<Trent_Reznor>	<wroteMusicFor>	<The_Social_Network>	<United_Arab_Emirates>
<Michael_Danzey>	<playsFor>	<Nottingham_Forest_F.C.>	<Italy>
<Carlos_Ruiz_(Guatemalan_footballer)>	<playsFor>	<D.C._United>	<Nigeria>
<Adel_Taarabt>	<isAffiliatedTo>	<Queens_Park_Rangers_F.C.>	<India>
<United_Nations_Operation_in_Somalia_II>	<happenedIn>	<Somalia>	<Austria>
<Westminster_School>	<isLocatedIn>	<City_of_Westminster>	<Poland>
<Terry_Dunfield>	<isAffiliatedTo>	<Canada_men's_national_soccer_team>	<Nigeria>
<Anonymous_(film)>	<isLocatedIn>	<United_Kingdom>	<Wales>
<Edward_Zwick>	<directed>	<The_Last_Samurai>	<Dominica>
<James_O'Connor_(footballer,_born_1984)>	<playsFor>	<Walsall_F.C.>	<Italy>
<Wehrmacht>	<isLocatedIn>	<Nazi_Germany>	<Senegal>
<Tommy_Wright_(footballer,_born_1963)>	<isAffiliatedTo>	<Nottingham_Forest_F.C.>	<Ukraine>
<Jimi_Hendrix>	<diedIn>	<Kensington>	<Republic_of_the_Congo>
<Youngstown,_Ohio>	<isLocatedIn>	<Trumbull_County,_Ohio>	<France>
<Lee_Ho_(footballer,_born_1984)>	<isAffiliatedTo>	<South_Korea_national_football_team>	<Hungary>
<Jocky_Wright>	<isAffiliatedTo>	<Watford_F.C.>	<India>
<Mark_Yates_(footballer)>	<isAffiliatedTo>	<Birmingham_City_F.C.>	<Jamaica>
<Tom_Hanks>	<actedIn>	<The_Green_Mile_(film)>	<Poland>
<Edward_Shearmur>	<wasBornIn>	<London>	<Japan>
<Alex_Manninger>	<isAffiliatedTo>	<ACF_Fiorentina>	<Bangladesh>
<Basil_Poledouris>	<wroteMusicFor>	<RoboCop>	<Jamaica>
<Lewis_Guy>	<playsFor>	<Newcastle_United_F.C.>	<Canada>
<Reg_Keating>	<playsFor>	<Birmingham_City_F.C.>	<Mali>
<John_Seasman>	<isAffiliatedTo>	<Rotherham_United_F.C.>	<Cyprus>
<Jim_McDonagh>	<isAffiliatedTo>	<Notts_County_F.C.>	<Hungary>
<Rashida_Jones>	<wasBornIn>	<Los_Angeles>	<Dominica>
<Harry_Roberts_(footballer,_born_1907)>	<wasBornIn>	<Barrow-in-Furness>	<Australia>
<Kenya>	<participatedIn>	<Operation_Enduring_Freedom>	<Tanzania>
<Jim_Goodwin>	<playsFor>	<Hamilton_Academical_F.C.>	<Panama>
<Joe_Garner>	<isAffiliatedTo>	<Blackburn_Rovers_F.C.>	<England>
<Belgrade>	<isLocatedIn>	<Serbia>	<Republic_of_Ireland>
<Queen_Victoria>	<created>	<Royal_Victorian_Order>	<El_Salvador>
<West_Java>	<hasWonPrize>	<Nobel_Prize_in_Physics>	<Ukraine>
<Peter_Marinello>	<wasBornIn>	<Edinburgh>	<Barbados>
<Grzegorz_Szamotulski>	<isAffiliatedTo>	<Legia_Warsaw>	<Cameroon>
<Nikodimos_Papavasiliou>	<isAffiliatedTo>	<Manager_(association_football)>	<Dominica>
<Jon_Newby>	<isAffiliatedTo>	<Crewe_Alexandra_F.C.>	<Martinique>
<Gus_Uhlenbeek>	<playsFor>	<Mansfield_Town_F.C.>	<France>
<Dimitar_Makriev>	<isAffiliatedTo>	<Inter_Milan>	<Poland>
<Toby_Ajala>	<isAffiliatedTo>	<Gateshead_F.C.>	<Croatia>
<Law_&_Order>	<isLocatedIn>	<United_States>	<Bulgaria>
<David_Thewlis>	<actedIn>	<Anonymous_(film)>	<Ukraine>
<Belarus>	<hasNeighbor>	<Lithuania>	<Dominica>
<Adam_Proudlock>	<isAffiliatedTo>	<Ipswich_Town_F.C.>	<Netherlands>
<Frankie_Sutherland>	<isAffiliatedTo>	<Woking_F.C.>	<Greece>
<Alan_Fettis>	<isAffiliatedTo>	<Nottingham_Forest_F.C.>	<Tanzania>
<Jimmy_Miller_(footballer)>	<isAffiliatedTo>	<Coventry_City_F.C.>	<China>
<John_Sutton_(footballer)>	<playsFor>	<Tottenham_Hotspur_F.C.>	<Republic_of_the_Congo>
<Etta_James>	<hasWonPrize>	<Grammy_Award>	<Austria>
<Joe_Walters_(footballer)>	<isAffiliatedTo>	<Rochdale_A.F.C.>	<Poland>
<Sean_Astin>	<actedIn>	<Click_(2006_film)>	<Cameroon>
<Ashley_Bayes>	<isAffiliatedTo>	<AFC_Wimbledon>	<Croatia>
<Ryan_Reynolds>	<actedIn>	<Smokin'_Aces>	<Chile>
<Peter_Gilbert>	<isAffiliatedTo>	<Leicester_City_F.C.>	<France>
<Danny_Cullip>	<isAffiliatedTo>	<Brighton_&_Hove_Albion_F.C.>	<United_Arab_Emirates>
<Sally_Field>	<actedIn>	<ER_(TV_series)>	<Ukraine>
<Dean_Saunders>	<isAffiliatedTo>	<Oxford_United_F.C.>	<Australia>
<Sanchez_Watt>	<isAffiliatedTo>	<Leeds_United_F.C.>	<Russia>
<nl/UNAMIS>	<isLocatedIn>	<Norway>	<Republic_of_Ireland>
<English_Civil_War>	<happenedIn>	<Kingdom_of_England>	<Martinique>
<Bonnie_Hunt>	<actedIn>	<A_Bug's_Life>	<Jamaica>
<Dave_Grohl>	<hasWonPrize>	<Grammy_Award>	<France>
<Ed_Helms>	<actedIn>	<The_Hangover>	<Democratic_Republic_of_the_Congo>
<George_Kirby_(footballer)>	<playsFor>	<Brentford_F.C.>	<Serbia>
<Peter_Beadle>	<playsFor>	<Port_Vale_F.C.>	<Monaco>
<Louis_Saha>	<wasBornIn>	<Paris>	<Austria>
<Neville_Roach>	<playsFor>	<Farnborough_F.C.>	<India>
<New_Rochelle,_New_York>	<isLocatedIn>	<United_States>	<Argentina>
<Barry_Richardson_(English_footballer)>	<isAffiliatedTo>	<Wycombe_Wanderers_F.C.>	<Israel>
<Alessandro_Rosina>	<isAffiliatedTo>	<A.C._Cesena>	<Germany>
<Jennifer_Connelly>	<livesIn>	<Brooklyn>	<England>
<Concord,_New_Hampshire>	<isLocatedIn>	<New_Hampshire>	<United_Kingdom>
<Carthage>	<isLocatedIn>	<Tunisia>	<Nigeria>
<Raphael_Meade>	<isAffiliatedTo>	<Odense_Boldklub>	<Tanzania>
<Ariel_Graziani>	<isAffiliatedTo>	<Newell's_Old_Boys>	<China>
<Tim_Curry>	<actedIn>	<Terry_Pratchett's_The_Colour_of_Magic>	<United_Kingdom>
<Monsef_Zerka>	<playsFor>	<Calcio_Catania>	<India>
<Willem_Dafoe>	<actedIn>	<Spider-Man_(2002_film)>	<Israel>
<Hugh_Laurie>	<actedIn>	<Arthur_Christmas>	<China>
<Chris_Cooper>	<actedIn>	<Capote_(film)>	<Poland>
<Eritrea>	<participatedIn>	<Operation_Enduring_Freedom_–_Horn_of_Africa>	<Wales>
<Shirley_MacLaine>	<actedIn>	<Cannonball_Run_II>	<Monaco>
<Huntington,_New_York>	<isLocatedIn>	<New_York_metropolitan_area>	<Bulgaria>
<James_Blunt>	<hasWonPrize>	<Brit_Awards>	<Iran>
<Béla_Guttmann>	<isAffiliatedTo>	<Panathinaikos_F.C.>	<Brazil>
<War_of_the_First_Coalition>	<happenedIn>	<Kingdom_of_Naples>	<Republic_of_the_Congo>
<Tommy_Anderson_(footballer)>	<isAffiliatedTo>	<Stockport_County_F.C.>	<Serbia>
<Meagan_Good>	<actedIn>	<The_Love_Guru>	<Democratic_Republic_of_the_Congo>
<Matthew_McConaughey>	<hasWonPrize>	<Independent_Spirit_Award_for_Best_Male_Lead>	<Germany>
<Lincoln_City_F.C.>	<isLocatedIn>	<Lincoln,_England>	<Senegal>
<Luis_Alonso_Sandoval>	<isAffiliatedTo>	<Monarcas_Morelia>	<Barbados>
<Robert_Loggia>	<actedIn>	<Lost_Highway_(film)>	<Germany>
<Igor_Mitreski>	<isAffiliatedTo>	<FC_Metalurh_Zaporizhya>	<United_Arab_Emirates>
<Gregor_Rioch>	<isAffiliatedTo>	<Macclesfield_Town_F.C.>	<Cameroon>
<Kevin_Austin>	<isAffiliatedTo>	<Leyton_Orient_F.C.>	<Iran>
<Equatorial_Guinea>	<hasOfficialLanguage>	<Spanish_language>	<Ukraine>
<Neil_Shipperley>	<isAffiliatedTo>	<Brentford_F.C.>	<Cameroon>
<Aron_Winter>	<isAffiliatedTo>	<AFC_Ajax>	<Republic_of_the_Congo>
<Late_Show_(CBS_TV_series)>	<isLocatedIn>	<United_States>	<Jamaica>
<Andy_Gray_(footballer,_born_1964)>	<isAffiliatedTo>	<England_national_football_team>	<Republic_of_the_Congo>
<Alejandro_Scopelli>	<isAffiliatedTo>	<Valencia_CF>	<Norway>
<Louie_Soares>	<playsFor>	<Ebbsfleet_United_F.C.>	<Slovenia>
<Chiyoda,_Tokyo>	<isLocatedIn>	<Tokyo>	<Australia>
<Dele_Adebola>	<playsFor>	<Rochdale_A.F.C.>	<Puerto_Rico>
<Frances_Marion>	<diedIn>	<Los_Angeles>	<Denmark>
<Province_of_Como>	<isLocatedIn>	<Como>	<Tanzania>
<Kemar_Roofe>	<isAffiliatedTo>	<Leeds_United_F.C.>	<Niger>
<Abel_Xavier>	<isAffiliatedTo>	<PSV_Eindhoven>	<Monaco>
<Ben_Wilkinson>	<isAffiliatedTo>	<Altrincham_F.C.>	<Northern_Ireland>
<Vietnam>	<isLocatedIn>	<Asia>	<Dominica>
<Bert_Powell>	<isAffiliatedTo>	<Chesterfield_F.C.>	<Tanzania>
<Clinton_Morrison>	<isAffiliatedTo>	<Colchester_United_F.C.>	<England>
<Alan_Daley>	<isAffiliatedTo>	<Cambridge_United_F.C.>	<United_Arab_Emirates>
<John_Rawls>	<graduatedFrom>	<Massachusetts_Institute_of_Technology>	<Belgium>
<Mohamed_Sissoko>	<isAffiliatedTo>	<Levante_UD>	<Norway>
<Simon_Callow>	<actedIn>	<Shakespeare_in_Love>	<Argentina>
<Gary_Alexander_(footballer)>	<isAffiliatedTo>	<AFC_Wimbledon>	<Croatia>
<Karan_Johar>	<directed>	<My_Name_Is_Khan>	<Norway>
<Billy_Zane>	<actedIn>	<The_Believer_(film)>	<Wales>
<New_England_Conservatory_of_Music>	<isLocatedIn>	<Massachusetts>	<Northern_Ireland>
<Matuzalém>	<playsFor>	<S.S._Lazio>	<Barbados>
<Daniel_Jones_(footballer)>	<isAffiliatedTo>	<Notts_County_F.C.>	<France>
<Pontifical_Gregorian_University>	<isLocatedIn>	<Italy>	<Wales>
<Charles_Brackett>	<created>	<Sunset_Boulevard_(film)>	<Iran>
<James_Fox>	<wasBornIn>	<London>	<United_Kingdom>
<Paul_Auster>	<wasBornIn>	<Newark,_New_Jersey>	<Scotland>
<Sean_Hayes_(actor)>	<wasBornIn>	<Chicago>	<Serbia>
<Derek_Jacobi>	<hasWonPrize>	<Tony_Award>	<Scotland>
<Costa_Rica>	<dealsWith>	<Mexico>	<Norway>
<Robert_Louis_Stevenson>	<influences>	<Arthur_Conan_Doyle>	<Denmark>
<Jamaica>	<dealsWith>	<Canada>	<Norway>
<Davide_Dionigi>	<playsFor>	<A.C._Milan>	<Bulgaria>
<Anthony_Williams_(footballer)>	<isAffiliatedTo>	<Bury_F.C.>	<Poland>
<Martin_Short>	<actedIn>	<The_Spiderwick_Chronicles_(film)>	<El_Salvador>
<Worcester_County,_Massachusetts>	<isLocatedIn>	<Worcester,_Massachusetts>	<Niger>
<Bam_Margera>	<actedIn>	<Jackass_3D>	<Russia>
<Chris_Killen>	<playsFor>	<Wrexham_A.F.C.>	<France>
<James_L._Brooks>	<hasWonPrize>	<Writers_Guild_of_America_Award>	<Greece>
<Leighton_Meester>	<wasBornIn>	<Fort_Worth,_Texas>	<Puerto_Rico>
<Elliot_Goldenthal>	<wroteMusicFor>	<Frida>	<Cape_Verde>
<Lewis_Montrose>	<isAffiliatedTo>	<Wigan_Athletic_F.C.>	<Hungary>
<45th_Annual_Grammy_Awards>	<isLocatedIn>	<New_York_City>	<Cyprus>
<Rosemary_Harris>	<actedIn>	<Sunshine_(1999_film)>	<England>
<Noah_Taylor>	<wasBornIn>	<London>	<Puerto_Rico>
<Eric_Jones_(footballer,_born_1915)>	<playsFor>	<Kidderminster_Harriers_F.C.>	<Russia>
<Jack_Nicholson>	<actedIn>	<A_Few_Good_Men>	<Argentina>
<Appalachian_Mountains>	<isLocatedIn>	<Virginia>	<El_Salvador>
<Bruno_Marioni>	<isAffiliatedTo>	<Villarreal_CF>	<El_Salvador>
<Thomas_Newman>	<wroteMusicFor>	<In_the_Bedroom>	<Norway>
<George_Lucas>	<graduatedFrom>	<University_of_Southern_California>	<Sweden>
<Lilo_&_Stitch>	<isLocatedIn>	<United_States>	<El_Salvador>
<2017_Romanian_protests>	<happenedIn>	<Vienna>	<El_Salvador>
<Hugo_Weaving>	<actedIn>	<The_Matrix>	<United_Kingdom>
<Eddie_McGoldrick>	<isAffiliatedTo>	<Republic_of_Ireland_national_football_team>	<Democratic_Republic_of_the_Congo>
<Surrey,_British_Columbia>	<isLocatedIn>	<British_Columbia>	<Serbia>
<Jean-Philippe_Javary>	<wasBornIn>	<Montpellier>	<Serbia>
<2009_Iranian_presidential_election_protests>	<happenedIn>	<Halifax,_Nova_Scotia>	<England>
<Ian_Redford>	<wasBornIn>	<Perth,_Scotland>	<Canada>
<Linda_Cardellini>	<actedIn>	<Super_(2010_American_film)>	<Belgium>
<Trevor_Ross>	<isAffiliatedTo>	<AEK_Athens_F.C.>	<Barbados>
<John_Cairns_(footballer)>	<playsFor>	<Leicester_City_F.C.>	<Spain>
<Amsterdam>	<isLocatedIn>	<North_Holland>	<Iran>
<Alex_Graves>	<wasBornIn>	<Kansas_City,_Missouri>	<Wales>
<Worthing>	<isLocatedIn>	<Sussex>	<Brazil>
<Lee_Holmes>	<isAffiliatedTo>	<Portsmouth_F.C.>	<Northern_Ireland>
<Nicky_Shorey>	<isAffiliatedTo>	<England_national_football_team>	<Sweden>
<Yoko_Ono>	<isMarriedTo>	<John_Lennon>	<Poland>
<Danny_Haynes>	<isAffiliatedTo>	<Bristol_City_F.C.>	<Germany>
<Kevin_Summerfield>	<playsFor>	<Cardiff_City_F.C.>	<Niger>
<2009_Sundance_Film_Festival>	<isLocatedIn>	<Ogden,_Utah>	<Greece>
<Michael_Owen>	<wasBornIn>	<Chester>	<England>
<Jimmy_Quinn_(footballer,_born_1959)>	<playsFor>	<Hereford_United_F.C.>	<Denmark>
<Ryan_McCann>	<isAffiliatedTo>	<Ayr_United_F.C.>	<United_Kingdom>
<Indo-Pakistani_War_of_1971>	<isLocatedIn>	<Bangladesh>	<Republic_of_Ireland>
<Dallas>	<isLocatedIn>	<Texas>	<Canada>
<Donna_Summer>	<wasBornIn>	<Boston>	<Democratic_Republic_of_the_Congo>
<Scott_Loach>	<isAffiliatedTo>	<Notts_County_F.C.>	<United_Arab_Emirates>
<Alfredo_Foni>	<isAffiliatedTo>	<Italy_national_football_team>	<Australia>
<2K_Games>	<isLocatedIn>	<United_States>	<Bulgaria>
<Orange_County,_California>	<isLocatedIn>	<California>	<Norway>
<Jimmy_Kennedy_(footballer)>	<isAffiliatedTo>	<Swindon_Town_F.C.>	<Iran>
<Ian_Harte>	<isAffiliatedTo>	<Leeds_United_F.C.>	<Canada>
<Emanuele_Pesaresi>	<isAffiliatedTo>	<Ternana_Calcio>	<Bahrain>
<Julian_de_Guzman>	<isAffiliatedTo>	<Canada_men's_national_soccer_team>	<Mali>
<82nd_Academy_Awards>	<happenedIn>	<Hollywood>	<United_States>
<Jon_Dahl_Tomasson>	<isAffiliatedTo>	<Roda_JC_Kerkrade>	<Sweden>
<Moses_Sakyi>	<isAffiliatedTo>	<Liberty_Professionals_F.C.>	<Kazakhstan>
<Marion_County,_Florida>	<isLocatedIn>	<Florida>	<Cameroon>
<John_Michael_Higgins>	<actedIn>	<A_Mighty_Wind>	<Belgium>
<Matt_McNeil>	<playsFor>	<Cambridge_United_F.C.>	<Sweden>
<Paul_Gascoigne>	<isAffiliatedTo>	<Kettering_Town_F.C.>	<Senegal>
<Jeff_Wealands>	<isAffiliatedTo>	<Northampton_Town_F.C.>	<Spain>
<Ian_Muir>	<isAffiliatedTo>	<Birmingham_City_F.C.>	<Argentina>
<Pablo_Mills>	<isAffiliatedTo>	<Derby_County_F.C.>	<Netherlands>
<Dominican_Republic>	<hasOfficialLanguage>	<Spanish_language>	<Barbados>
<Shatrughan_Sinha>	<wasBornIn>	<Patna>	<Niger>
<Alex_MacDonald_(footballer,_born_1990)>	<wasBornIn>	<Warrington>	<Argentina>
<Chris_Eagles>	<isAffiliatedTo>	<Watford_F.C.>	<Democratic_Republic_of_the_Congo>
<Sabri_Lamouchi>	<isAffiliatedTo>	<Inter_Milan>	<Spain>
<James_Newton_Howard>	<wroteMusicFor>	<Mumford_(film)>	<Cameroon>
<Ralph_Fiennes>	<actedIn>	<The_English_Patient_(film)>	<Poland>
<Barry_Levinson>	<directed>	<Wag_the_Dog>	<Senegal>
<CBS_Corporation>	<isLocatedIn>	<United_States>	<Scotland>
<King_Records_(United_States)>	<isLocatedIn>	<Cincinnati>	<Iran>
<Olof_Mellberg>	<isAffiliatedTo>	<AIK_Fotboll>	<Iran>
<Frank_Fielding>	<isAffiliatedTo>	<Leeds_United_F.C.>	<Republic_of_the_Congo>
<David_Davis_(footballer)>	<isAffiliatedTo>	<Darlington_F.C.>	<Sweden>
<Gary_Kelly_(footballer,_born_1966)>	<playsFor>	<Sheffield_United_F.C.>	<England>
<Greenwood,_Mississippi>	<isLocatedIn>	<United_States>	<Monaco>
<Art_Carney>	<actedIn>	<Last_Action_Hero>	<Greece>
<Peter_Nicholas_(footballer)>	<wasBornIn>	<Newport,_Wales>	<Niger>
<Transylvania>	<isLocatedIn>	<Europe>	<Bulgaria>
<Steve_Robinson_(Northern_Ireland_footballer)>	<isAffiliatedTo>	<Luton_Town_F.C.>	<United_States>
<Riccardo_Meggiorini>	<playsFor>	<A.C._ChievoVerona>	<Tanzania>
<Patrick_van_Aanholt>	<isAffiliatedTo>	<SBV_Vitesse>	<Republic_of_Ireland>
<Eiður_Guðjohnsen>	<playsFor>	<Molde_FK>	<England>
<Carl_Alford>	<playsFor>	<Stockport_County_F.C.>	<Scotland>
<NBCUniversal>	<owns>	<Amblin_Entertainment>	<Bulgaria>
<Shohreh_Aghdashloo>	<hasWonPrize>	<Independent_Spirit_Awards>	<Denmark>
<Chris_Makin>	<isAffiliatedTo>	<Reading_F.C.>	<Canada>
<David_Brightwell>	<playsFor>	<Bradford_City_A.F.C.>	<Austria>
<Iraq>	<dealsWith>	<Greece>	<Kazakhstan>
<Davide_Dionigi>	<playsFor>	<Spezia_Calcio>	<Bulgaria>
<Karl_Ready>	<isAffiliatedTo>	<Farnborough_F.C.>	<United_States>
<Kevin_Phillips_(footballer)>	<isAffiliatedTo>	<Aston_Villa_F.C.>	<Israel>
<Conor_Sammon>	<playsFor>	<Ipswich_Town_F.C.>	<Democratic_Republic_of_the_Congo>
<Innsbruck>	<isLocatedIn>	<Tyrol_(state)>	<Mali>
<Tangled>	<isLocatedIn>	<United_States>	<Panama>
<Boise_State_University>	<isLocatedIn>	<Boise,_Idaho>	<Serbia>
<Yale_School_of_Medicine>	<isLocatedIn>	<New_Haven,_Connecticut>	<Italy>
<Andy_Serkis>	<actedIn>	<Inkheart_(film)>	<Netherlands>
<University_of_Vienna>	<isLocatedIn>	<Vienna>	<United_Kingdom>
<Nikodimos_Papavasiliou>	<playsFor>	<Newcastle_United_F.C.>	<Dominica>
<Ottoman_Empire>	<participatedIn>	<Napoleonic_Wars>	<Niger>
<Joseph_S._O'Leary>	<isInterestedIn>	<Georg_Wilhelm_Friedrich_Hegel>	<Martinique>
<Damjan_Đoković>	<isAffiliatedTo>	<A.S._Livorno_Calcio>	<Canada>
<Paul_Kinnaird>	<isAffiliatedTo>	<Shrewsbury_Town_F.C.>	<United_Arab_Emirates>
<Michael_Laudrup>	<playsFor>	<S.S._Lazio>	<Northern_Ireland>
<Animax>	<isLocatedIn>	<Cuba>	<Niger>
<Ferenc_Puskás>	<isAffiliatedTo>	<Panathinaikos_F.C.>	<Greece>
<Andy_Ferrell>	<isAffiliatedTo>	<York_City_F.C.>	<United_Kingdom>
<Edgar_Rice_Burroughs>	<influences>	<Peter_David>	<Russia>
<Sienna_Miller>	<wasBornIn>	<New_York_City>	<Israel>
<Jim_Fryatt>	<wasBornIn>	<Southampton>	<Jamaica>
<Wayne_Cegielski>	<isAffiliatedTo>	<Port_Vale_F.C.>	<Democratic_Republic_of_the_Congo>
<Peter_Molloy_(footballer,_born_1909)>	<playsFor>	<Queens_Park_Rangers_F.C.>	<Australia>
<Epic_Soundtrax>	<isLocatedIn>	<Los_Angeles>	<India>
<Lily_Tomlin>	<actedIn>	<And_the_Band_Played_On_(film)>	<Russia>
<Ludacris>	<created>	<Burning_Bridges_(Ludacris_EP)>	<United_States>
<Aaron_Shure>	<wasBornIn>	<United_States>	<China>
<Japan>	<hasCurrency>	<Japanese_yen>	<Kazakhstan>
<Loïc_Rémy>	<isAffiliatedTo>	<Olympique_Lyonnais>	<Poland>
<Thomas_Ian_Nicholas>	<actedIn>	<American_Pie_(film)>	<Sweden>
<Larenz_Tate>	<actedIn>	<Ray_(film)>	<Croatia>
<Patrick_Kanyuka>	<playsFor>	<Tamworth_F.C.>	<Northern_Ireland>
<Stuart_McMillan_(footballer)>	<isAffiliatedTo>	<Gillingham_F.C.>	<Argentina>
<Lee_Fowler>	<isAffiliatedTo>	<Oxford_United_F.C.>	<Bulgaria>
<Richard_Burton>	<actedIn>	<Anne_of_the_Thousand_Days>	<United_States>
<Aimee_Mann>	<wasBornIn>	<Richmond,_Virginia>	<Barbados>
<Derek_McInnes>	<isAffiliatedTo>	<Dundee_United_F.C.>	<United_Kingdom>
<Peter_Meehan>	<isAffiliatedTo>	<Clyde_F.C.>	<Dominica>
<Monroe,_Louisiana>	<isLocatedIn>	<Louisiana>	<Bahrain>
<Graham_Potter>	<playsFor>	<Birmingham_City_F.C.>	<Belgium>
<Astrit_Ajdarević>	<isAffiliatedTo>	<AEK_Athens_F.C.>	<Norway>
<The_Golden_Compass_(film)>	<isLocatedIn>	<United_States>	<Bangladesh>
<Crispin_Freeman>	<wasBornIn>	<Chicago>	<United_States>
<Bas_Savage>	<isAffiliatedTo>	<Gillingham_F.C.>	<Germany>
<Alessandro_Bastrini>	<playsFor>	<Calcio_Catania>	<Switzerland>
<Les_Ferdinand>	<playsFor>	<Tottenham_Hotspur_F.C.>	<Senegal>
<James_Newton_Howard>	<wroteMusicFor>	<The_Bourne_Legacy_(film)>	<Cameroon>
<Bruce_Greenwood>	<actedIn>	<Swept_Away_(2002_film)>	<Bangladesh>
<Micky_Adams>	<isAffiliatedTo>	<Sheffield_United_F.C.>	<Spain>
<War_of_the_Spanish_Succession>	<happenedIn>	<South_America>	<Barbados>
<Rajinikanth>	<wasBornIn>	<Bangalore>	<Tanzania>
<Andrew_Stanton>	<created>	<Finding_Nemo>	<Dominica>
<Taking_Woodstock>	<isLocatedIn>	<United_States>	<Kazakhstan>
<John_Malkovich>	<actedIn>	<The_Man_in_the_Iron_Mask_(1998_film)>	<Cameroon>
<Leroy_Lita>	<playsFor>	<Middlesbrough_F.C.>	<United_Arab_Emirates>
<Jordan_Rose>	<playsFor>	<A.F.C._Telford_United>	<Austria>
<Syria>	<hasCapital>	<Damascus>	<Wales>
<Sean_Connery>	<actedIn>	<The_Name_of_the_Rose_(film)>	<Barbados>
<Darius_Henderson>	<playsFor>	<Coventry_City_F.C.>	<England>
<Simon_Gillett>	<wasBornIn>	<Oxford>	<Cameroon>
<Bas_Savage>	<isAffiliatedTo>	<Bury_F.C.>	<Germany>
<Shanghai_Greenland_Shenhua_F.C.>	<isLocatedIn>	<Shanghai>	<Switzerland>
<Branco_(footballer)>	<playsFor>	<New_York_Red_Bulls>	<Puerto_Rico>
<Claude_Rains>	<hasWonPrize>	<Donaldson_Awards>	<Niger>
<Joaquin_Phoenix>	<actedIn>	<The_Master_(2012_film)>	<Bulgaria>
<Byzantine_Empire>	<hasOfficialLanguage>	<Latin>	<Kazakhstan>
<Tarcisio_Burgnich>	<isAffiliatedTo>	<Juventus_F.C.>	<Hungary>
<Ardent_Records>	<isLocatedIn>	<Memphis,_Tennessee>	<Kazakhstan>
<Macalester_College>	<isLocatedIn>	<Minnesota>	<Northern_Ireland>
<Dean_Howell>	<isAffiliatedTo>	<Notts_County_F.C.>	<Bulgaria>
<Dave_Mackay>	<diedIn>	<Nottingham>	<Scotland>
<Jack_Nicholson>	<actedIn>	<Easy_Rider>	<Argentina>
<Daniel_Inouye>	<hasWonPrize>	<Medal_of_Honor>	<Northern_Ireland>
<Matt_Jackson>	<isAffiliatedTo>	<Watford_F.C.>	<Jamaica>
<Nikola_Vujadinović>	<wasBornIn>	<Belgrade>	<Greece>
<Paul_Haggis>	<livesIn>	<Santa_Monica,_California>	<Bahrain>
<Martin_Hodge>	<isAffiliatedTo>	<Oldham_Athletic_A.F.C.>	<Belgium>
<Steve_Anthrobus>	<isAffiliatedTo>	<Hednesford_Town_F.C.>	<Cyprus>
<Venezuela>	<dealsWith>	<Spain>	<Spain>
<Jane_Lynch>	<actedIn>	<Role_Models>	<United_Arab_Emirates>
<Clyde_Wijnhard>	<playsFor>	<Darlington_F.C.>	<Senegal>
<Canada>	<participatedIn>	<Operation_Ocean_Shield>	<Puerto_Rico>
<SV_Darmstadt_98>	<isLocatedIn>	<Darmstadt>	<Germany>
<Marco_Motta>	<playsFor>	<Watford_F.C.>	<Chile>
<Robert_A._Heinlein>	<influences>	<Charles_Stross>	<El_Salvador>
<Brian_Kidd>	<isAffiliatedTo>	<Bolton_Wanderers_F.C.>	<Italy>
<Abigail_Breslin>	<actedIn>	<Zombieland>	<Mali>
<Tony_Pulis>	<isAffiliatedTo>	<Bristol_Rovers_F.C.>	<Cyprus>
<Rabindranath_Tagore>	<wasBornIn>	<Kolkata>	<Russia>
<Rocky_Mountains>	<isLocatedIn>	<Wyoming>	<Switzerland>
<Miguel_de_Cervantes>	<influences>	<J._M._Coetzee>	<Martinique>
<Michael_Spillane_(footballer)>	<isAffiliatedTo>	<Southend_United_F.C.>	<Republic_of_the_Congo>
<Romano_Perticone>	<playsFor>	<U.C._Sampdoria>	<Tanzania>
<Darryl_Flahavan>	<isAffiliatedTo>	<Crystal_Palace_F.C.>	<Martinique>
<Mick_Bodley>	<isAffiliatedTo>	<Peterborough_United_F.C.>	<Nigeria>
<John_McGuigan>	<playsFor>	<Swansea_City_A.F.C.>	<Barbados>
<Dave_Metchick>	<playsFor>	<Woking_F.C.>	<Australia>
<Richard_Key>	<wasBornIn>	<Cambridge>	<Brazil>
<Tom_Cowan>	<isAffiliatedTo>	<Sheffield_United_F.C.>	<Cyprus>
<Jimmy_Gauld>	<isAffiliatedTo>	<Everton_F.C.>	<United_Arab_Emirates>
<Gainesville,_Florida>	<isLocatedIn>	<United_States>	<United_States>
<Paul_Rachubka>	<isAffiliatedTo>	<Bury_F.C.>	<Barbados>
<Sanmi_Odelusi>	<isAffiliatedTo>	<Reading_F.C.>	<Cyprus>
<Philip_Yordan>	<hasWonPrize>	<Edgar_Award>	<Netherlands>
<2010_Winter_Olympics>	<isLocatedIn>	<Canada>	<Iran>
<Scott_Loach>	<playsFor>	<Notts_County_F.C.>	<United_Arab_Emirates>
<Tom_Cowan>	<isAffiliatedTo>	<Barrow_A.F.C.>	<Cyprus>
<Simeon_Hodson>	<isAffiliatedTo>	<Lincoln_City_F.C.>	<Barbados>
<Citrus_County,_Florida>	<isLocatedIn>	<Florida>	<Monaco>
<Jordan_Parkes>	<isAffiliatedTo>	<Chelmsford_City_F.C.>	<Serbia>
<Alexander_Payne>	<hasWonPrize>	<Academy_Award_for_Best_Adapted_Screenplay>	<United_Arab_Emirates>
<Albano_Bizzarri>	<isAffiliatedTo>	<Delfino_Pescara_1936>	<Republic_of_the_Congo>
<Habsburg_Monarchy>	<participatedIn>	<War_of_the_Polish_Succession>	<Republic_of_Ireland>
<W._E._B._Du_Bois>	<livesIn>	<Georgia_(U.S._state)>	<Iran>
<Scott_Canham>	<isAffiliatedTo>	<Leyton_Orient_F.C.>	<Wales>
<2017_Romanian_protests>	<happenedIn>	<Glasgow>	<El_Salvador>
<Road_to_Ultra>	<isLocatedIn>	<Mumbai>	<Iran>
<Charlie_Miller>	<isAffiliatedTo>	<SK_Brann>	<Scotland>
<Aidan_Davison>	<isAffiliatedTo>	<Sheffield_United_F.C.>	<Russia>
<Aly_Cissokho>	<isAffiliatedTo>	<France_national_football_team>	<Northern_Ireland>
<Mali>	<isLocatedIn>	<Africa>	<France>
<Eric_Wynalda>	<playsFor>	<New_England_Revolution>	<Spain>
<Michigan>	<hasOfficialLanguage>	<English_language>	<Niger>
<Chris_Powell>	<isAffiliatedTo>	<Huddersfield_Town_A.F.C.>	<Russia>
<Carl_Sagan>	<hasWonPrize>	<Pulitzer_Prize_for_General_Nonfiction>	<Italy>
<Mike_Salmon>	<isAffiliatedTo>	<Bolton_Wanderers_F.C.>	<Slovenia>
<Kasey_Keller>	<wasBornIn>	<Olympia,_Washington>	<France>
<Interscope_Records>	<isLocatedIn>	<United_States>	<Kazakhstan>
<Thomas_Brodie-Sangster>	<actedIn>	<Bright_Star_(film)>	<El_Salvador>
<Andrew_Davies_(footballer)>	<isAffiliatedTo>	<Queens_Park_Rangers_F.C.>	<Bahrain>
<Shirley_Ann_Russell>	<diedIn>	<London>	<United_Kingdom>
<Luís_Leal_(footballer)>	<playsFor>	<C.F._Os_Belenenses>	<Israel>
<Scott_McDonald>	<isAffiliatedTo>	<A.F.C._Bournemouth>	<Australia>
<Michael_Shannon>	<actedIn>	<Man_of_Steel_(film)>	<Chile>
<Michael_Chabon>	<hasWonPrize>	<Nebula_Award>	<Denmark>
