sentences	sensitiveAttr
<Use_conventional_military_force>Mamadou_Ndala,	<City_Mayor_(Indonesia)>
<Host_a_visit>Congress_(United_States),<Consult>Sergey_Kuzhugetovich_Shoygu,<Consult>Sabah_Khaled_Al-Hamad_Al-Sabah,<Consult>Amr_Mohammed_Moussa,	<Media_(Africa)>
<Consult>Foreign_Affairs_(India),	<Independence_Party>
<Praise_or_endorse>Ethiopia,	<Kivutha_Kibwana>
<Criticize_or_denounce>Armed_Gang_(Afghanistan),	<John_Kerry>
<Consult>People_Associated_with_the_Opposition_(Turkey),<Appeal_to_others_to_meet_or_negotiate>Opposition_Supporter_(Turkey),<Consult>Giorgio_Napolitano,	<Businessperson_(Turkey)>
<Make_a_visit>Afghanistan,	<Armed_Gang_(Saudi_Arabia)>
<Consult>UN_Security_Council,	<Veterans_(Croatia)>
<Praise_or_endorse>Police_(Central_African_Republic),	<Ministry_(Nigeria)>
<Host_a_visit>Bismillah_Khan_Mohammadi,<Praise_or_endorse>Romania,	<Armed_Band_(Afghanistan)>
<Make_a_visit>Ethiopia,<Consult>Ethiopia,	<Lawyer/Attorney_(Colombia)>
<Discuss_by_telephone>François_Hollande,<Consult>Irakli_Alasania,	<Hamas>
<Consult>Head_of_Government_(India),	<Xi_Jinping>
<Praise_or_endorse>Government_(Syria),	<Oman>
<Accuse>Ministry_(Nigeria),	<Government_(Nigeria)>
<Criticize_or_denounce>Guatemala,	<Scientist_(Tajikistan)>
<Consult>Defense_/_Security_Ministry_(Egypt),<Consult>Abdel_Fattah_Al-Sisi,	<Hamdeen_Sabahi>
<Express_intent_to_meet_or_negotiate>Representatives_(Senegal),	<China>
<Demand>Yulia_Tymoshenko,<Make_a_visit>France,<Express_intent_to_cooperate>Vitali_Klitschko,<Express_intent_to_engage_in_diplomatic_cooperation_(such_as_policy_support)>Barack_Obama,<Consult>François_Hollande,	<Madeleine_Albright>
<Host_a_visit>Paul_Kagame,<Host_a_visit>Ministry_(United_States),	<Congo>
<Mobilize_or_increase_armed_forces>Military_(Russia),	<Benazir_Bhutto>
<Occupy_territory>Iraq,	<Argentine_Naval_Prefecture>
<Abduct_hijack_or_take_hostage>Trade_Official_(South_Korea),	<Court_Judge_(Iraq)>
<fight_with_small_arms_and_light_weapons>Police_(Saudi_Arabia),	<Umar_al_Bashir>
<fight_with_small_arms_and_light_weapons>Citizen_(Thailand),	<Media_Personnel_(Thailand)>
<fight_with_small_arms_and_light_weapons>Citizen_(Thailand),	<Police_(Middle_East)>
<Use_unconventional_violence>Combatant_(Al_Qaeda),<Express_accord>Government_(Syria),	<United_Progressive_Alliance>
<Use_unconventional_violence>Citizen_(Yemen),	<Ri_Su_Yong>
<Consult>Government_Official_(United_States),	<Head_of_Government_(Ukraine)>
<Make_an_appeal_or_request>Government_(United_Arab_Emirates),	<Armed_Gang_(Egypt)>
<Host_a_visit>John_Kerry,	<Head_of_Government_(Ukraine)>
<Use_unconventional_violence>Afghanistan,	<Legislature_(Libya)>
<fight_with_artillery_and_tanks>Mamadou_Ndala,	<Police_(Namibia)>
<Use_unconventional_violence>Citizen_(Germany),	<Ethnic_Group_(India)>
<Use_unconventional_violence>Military_Personnel_(Libya),	<Benazir_Bhutto>
<fight_with_small_arms_and_light_weapons>Israeli_Defense_Forces,	<Daniel_Barrera_Barrera>
<fight_with_small_arms_and_light_weapons>Citizen_(Tanzania),	<Catherine_Ashton>
<Use_unconventional_violence>Lee_Rigby,	<Other_Authorities_/_Officials_(Hong_Kong)>
<Make_empathetic_comment>Citizen_(Australia),	<Owen_Ellington>
<Appeal_for_diplomatic_cooperation_(such_as_policy_support)>Member_of_Parliament_(Bangladesh),<Accuse>Activist_(Jamaat_I_Islami),	<Government_(South_Africa)>
<Make_an_appeal_or_request>Governor_(India),	<Amit_Shah>
<Arrest_detain_or_charge_with_legal_action>Men_(Bahrain),	<Republican_People's_Party>
<Express_intent_to_meet_or_negotiate>Abdul_Hamid,<Make_an_appeal_or_request>Citizen_(Bangladesh),	<Awami_(People's)_League>
<Praise_or_endorse>Coalition_of_the_Radical_Left,	<Office_of_the_United_Nations_High_Commissioner_for_Human_Rights>
<Provide_military_aid>Armed_Rebel_(Syria),<Express_intent_to_meet_or_negotiate>Japan,<Make_a_visit>North_Atlantic_Treaty_Organization,<Appeal_for_release_of_persons_or_property>Other_Authorities_/_Officials_(Venezuela),<Consult>Canada,<Criticize_or_denounce>Afghanistan,<Make_a_visit>France,<Engage_in_negotiation>Legislature_(Iraq),<Express_intent_to_meet_or_negotiate>Philippines,<Express_intent_to_meet_or_negotiate>Mexico,<Provide_economic_aid>Afghanistan,<Express_intent_to_cooperate_economically>Vietnam,<Reject>China,<Express_intent_to_meet_or_negotiate>François_Hollande,	<North_Atlantic_Treaty_Organization>
<Demand>Citizen_(Australia),	<Governor_(Spain)>
<Express_intent_to_meet_or_negotiate>Barack_Obama,<Engage_in_negotiation>Benny_Gantz,<Consult>Barack_Obama,<Deny_responsibility>Cabinet_/_Council_of_Ministers_/_Advisors_(United_States),	<John_Kerry>
<Criticize_or_denounce>Azubuike_Ihejirika,	<Uhuru_Muigai_Kenyatta>
<fight_with_small_arms_and_light_weapons>Education_(Nigeria),	<Government_(Nigeria)>
<Engage_in_diplomatic_cooperation>France,	<Business_(Russia)>
<fight_with_small_arms_and_light_weapons>Criminal_(Pakistan),	<Pakistan_Tehreek-e-Insaf>
<Criticize_or_denounce>Citizen_(Cote_d'Ivoire),	<City_Mayor_(Croatia)>
<Express_intent_to_cooperate>Iran,<Demand_diplomatic_cooperation_(such_as_policy_support)>Iran,	<Armed_Gang_(Benin)>
<Criticize_or_denounce>Labor_Party_(United_Kingdom),	<Oil_Tanker_(Bangladesh)>
<Make_an_appeal_or_request>Sergey_Viktorovich_Lavrov,	<Ethnic_Group_(India)>
<Host_a_visit>Xi_Jinping,<Threaten>Government_(Syria),<Engage_in_negotiation>Foreign_Affairs_(South_Korea),<Make_a_visit>China,<Make_a_visit>South_Korea,<Consult>Xi_Jinping,<Express_intent_to_cooperate>Philippines,<Sign_formal_agreement>Benjamin_Netanyahu,	<Fumio_Kishida>
<Make_a_visit>South_Korea,<Impose_embargo_boycott_or_sanctions>North_Korea,<Express_intent_to_meet_or_negotiate>Iran,	<Liberal_Party_(Canada)>
<Engage_in_diplomatic_cooperation>China,	<Lawyer/Attorney_(Uganda)>
<Engage_in_negotiation>Keiji_Furuya,	<Head_of_Government_(Nigeria)>
<Engage_in_negotiation>Wendy_Sherman,<Express_intent_to_meet_or_negotiate>People_Associated_with_the_Opposition_(Ukraine),<Make_an_appeal_or_request>Government_(Venezuela),<Discuss_by_telephone>Sergey_Viktorovich_Lavrov,<Make_a_visit>United_Arab_Emirates,<Express_intent_to_meet_or_negotiate>Sergey_Viktorovich_Lavrov,<Consult>Vitali_Klitschko,	<Iran>
<Arrest_detain_or_charge_with_legal_action>Military_Personnel_(India),	<Media_(Africa)>
<Reject>Philippines,<Express_intent_to_engage_in_diplomatic_cooperation_(such_as_policy_support)>Tanzania,<Host_a_visit>Michael_Sata,<Express_intent_to_engage_in_diplomatic_cooperation_(such_as_policy_support)>African_Union,<Make_an_appeal_or_request>North_Korea,<Host_a_visit>Mamnoon_Hussain,<Make_an_appeal_or_request>Japan,<Host_a_visit>Ministry_(Mainland_Affairs_Council),<Make_empathetic_comment>Citizen_(South_Korea),<Host_a_visit>Nicolai_Wammen,<Make_an_appeal_or_request>Citizen_(International),<Praise_or_endorse>Cabinet_/_Council_of_Ministers_/_Advisors_(United_States),<Engage_in_diplomatic_cooperation>Cape_Verde,<Express_intent_to_cooperate_economically>Romania,<Reject>France,<Make_optimistic_comment>Vietnam,<Host_a_visit>Kamla_Persad-Bissessar,<Threaten>Vietnam,<Host_a_visit>Kim_Jong-Un,<Criticize_or_denounce>Japan,<Reject>Lawmaker_(Japan),<Express_intent_to_engage_in_diplomatic_cooperation_(such_as_policy_support)>France,<Host_a_visit>John_Kerry,<Praise_or_endorse>Iraq,<Host_a_visit>Foreign_Affairs_(Mongolia),	<Afghanistan>
<Discuss_by_telephone>Sergey_Kuzhugetovich_Shoygu,<Consult>Japan,	<Iran>
<Appeal_to_engage_in_or_accept_mediation>Peter_O'Neill,<Threaten>Election_Commission_(Australia),<Demonstrate_or_rally>Police_(Australia),	<Military_(China)>
<Reject>Sheikh_Hasina_Wajed,<Demand>Employee_(Bangladesh),<Make_an_appeal_or_request>Abdul_Hamid,	<Justin_Trudeau>
<Use_unconventional_violence>Criminal_(Brazil),	<Dalbir_Singh>
<Make_an_appeal_or_request>Military_Personnel_-_Special_(Cote_d'Ivoire),	<Pope_Francis>
<Deny_responsibility>Newspaper_(Germany),	<Member_of_Legislative_(Govt)_(Kenya)>
<Use_unconventional_violence>Aam_Aadmi_Party,<Appeal_for_diplomatic_cooperation_(such_as_policy_support)>Employee_(India),<Accuse>Teesta_Setalvad,<Use_unconventional_violence>Company_-_Owner_or_Operator_(India),<Make_an_appeal_or_request>Aam_Aadmi_Party,<Deny_responsibility>Raj_Thackeray,<Criticize_or_denounce>Minister_Patnaik,<Make_an_appeal_or_request>Labor_Department_(India),<Make_an_appeal_or_request>Environment_Department/Ministry_(India),<Make_an_appeal_or_request>Associated_Press,<Express_intent_to_cooperate>Court_Judge_(India),<Make_an_appeal_or_request>Employee_(India),<Bring_lawsuit_against>Sunil_Kumar,<Sexually_assault>Medical_Personnel_(India),<Express_intent_to_meet_or_negotiate>Head_of_Government_(India),<Make_an_appeal_or_request>Omar_Abdullah,	<Education_(Nigeria)>
<Express_intent_to_engage_in_diplomatic_cooperation_(such_as_policy_support)>Iran,	<Business_(Canada)>
<Accuse>Gideon_Mung'aro,<Use_unconventional_violence>Governor_(Kenya),<Make_an_appeal_or_request>William_Ruto,<Make_an_appeal_or_request>Uhuru_Muigai_Kenyatta,<Demonstrate_or_rally>William_Kabogo,<Demand>Governor_(Kenya),<Criticize_or_denounce>Police_(Kenya),<Bring_lawsuit_against>Government_(Kenya),<Make_an_appeal_or_request>Public_Works_(Kenya),	<Volvo>
<Demonstrate_or_rally>Police_(Kosovo),	<United_Arab_Emirates>
<Make_an_appeal_or_request>Ministry_(Kyrgyzstan),	<Secretariat_(Egypt)>
<Criticize_or_denounce>National_Front_Malaysia,	<Foreign_Affairs_(Chile)>
<Criticize_or_denounce>Government_(Namibia),<Physically_assault>Court_Judge_(Namibia),<Make_an_appeal_or_request>Election_Commission_(Namibia),	<Ruling_Party_(India)>
<Make_an_appeal_or_request>Education_(Nigeria),<Accuse>Nigerian_National_Petroleum_Corporation,<Deny_responsibility>Congress_(Nigeria),<Criticize_or_denounce>Kashim_Shettima,<Criticize_or_denounce>Government_(Nigeria),<Bring_lawsuit_against>Government_(Nigeria),<Express_intent_to_engage_in_diplomatic_cooperation_(such_as_policy_support)>Other_Authorities_/_Officials_(Nigeria),	<Employee_(Kuwait)>
<Reject>North_Korea,<Express_intent_to_engage_in_diplomatic_cooperation_(such_as_policy_support)>North_Korea,	<Cabinet_/_Council_of_Ministers_/_Advisors_(United_States)>
<Express_intent_to_meet_or_negotiate>South_Korea,	<Arnaud_Montebourg>
<Occupy_territory>Police_(Sudan),	<Head_of_Government_(Germany)>
<Use_unconventional_violence>Tanzania,<Threaten>Criminal_(Tanzania),	<Other_Authorities_/_Officials_(Egypt)>
<Express_intent_to_meet_or_negotiate>Thailand,<Obstruct_passage_block>Thailand,<Reject>Thaksin_Shinawatra,<Demonstrate_or_rally>Thailand,<Use_unconventional_violence>Protester_(Thailand),<Appeal_for_military_aid>Thailand,<fight_with_small_arms_and_light_weapons>Thailand,<Demonstrate_or_rally>Student_(Thailand),<Criticize_or_denounce>Protester_(Thailand),	<Martin_McGuinness>
<Use_unconventional_violence>Nationalist_Movement_Party,	<Government_(France)>
<Express_intent_to_engage_in_diplomatic_cooperation_(such_as_policy_support)>Nuri_al-Maliki,	<Government_(Nepal)>
<Criticize_or_denounce>Northern_Ireland,<Reject>Conservative_Party_(United_Kingdom),<Bring_lawsuit_against>Scientist_(United_Kingdom),<Make_an_appeal_or_request>Theresa_May,<Use_unconventional_violence>Alex_Salmond,<fight_with_small_arms_and_light_weapons>Police_(United_States),	<Member_of_Parliament_(Ukraine)>
<Use_unconventional_violence>Police_(Yemen),<Abduct_hijack_or_take_hostage>Citizen_(Germany),	<Volvo>
<Accuse>Citizen_(Kenya),<Make_an_appeal_or_request>Political_Parties_(Zambia),<Make_an_appeal_or_request>Professor_(Zambia),	<Employee_(Philippines)>
<Make_a_visit>Philippines,	<Governor_(Spain)>
<Express_intent_to_cooperate_on_intelligence>Mexico,	<Combatant_(Islamic_State_of_Iraq_and_the_Levant)>
<Use_unconventional_violence>Armed_Rebel_(Syria),	<Abu_Sayyaf>
<Use_unconventional_violence>Militant_(Yemen),	<Thief_(India)>
<Protest_violently_riot>Labor_Union_(Nigeria),	<Industry_(South_Africa)>
<Make_an_appeal_or_request>Party_Member_(Thailand),	<Moro_National_Liberation_Front>
<Consult>Head_of_Government_(Pakistan),	<Armed_Rebel_(Yemen)>
<Accuse>Enrico_Letta,	<Al_Jazeera>
<Criticize_or_denounce>Government_(South_Africa),	<Tonga>
<Consult>Election_Commission_(India),	<Student_(Tanzania)>
<Express_intent_to_cooperate>Citizen_(India),<Arrest_detain_or_charge_with_legal_action>Men_(India),	<Medical_Personnel_(India)>
<Return_release_person(s)>Citizen_(Kenya),<Demand>Governor_(Kenya),	<Media_(Saudi_Arabia)>
<Accuse>Citizen_(Nigeria),	<Oversight_Court_(Nigeria)>
<Express_intent_to_meet_or_negotiate>Citizen_(Australia),	<Head_of_Government_(Germany)>
<Abduct_hijack_or_take_hostage>Men_(Mexico),	<Social_Democratic_Party_(Lithuania)>
<Consult>Foreign_Affairs_(Venezuela),	<Government_(Argentina)>
<Appeal_for_diplomatic_cooperation_(such_as_policy_support)>China,	<Armed_Gang_(United_States)>
<Consult>Radio_Mitre,	<Government_(Argentina)>
<Consult>Bulgarian_National_Radio,	<Milos_Zeman>
<Express_intent_to_meet_or_negotiate>Serbia,	<Austria_Press_Agency>
<Make_a_visit>Foreign_Affairs_(South_Korea),	<Benjamin_Netanyahu>
<Mediate>Ethiopia,	<United_States_Senate>
<Reject>Police_(Ukraine),	<Ministry_(Afghanistan)>
<Demand_diplomatic_cooperation_(such_as_policy_support)>Military_(Lebanon),	<Associated_Press>
<Consult>Mahmoud_Ahmadinejad,	<Sergey_Viktorovich_Lavrov>
<Praise_or_endorse>Government_(Nigeria),	<Canadian_Armed_Forces>
<Engage_in_diplomatic_cooperation>Governor_(Angola),	<Ministry_(Zimbabwe)>
<Consult>Council_of_States,	<Ministry_(Czech_Republic)>
<Praise_or_endorse>Citizen_(Nigeria),	<Other_Authorities_/_Officials_(Libya)>
<Accuse>Citizen_(India),<Complain_officially>Citizen_(India),	<Thief_(India)>
<Accuse>Citizen_(Saudi_Arabia),	<Héctor_Beltrán_Leyva>
<Make_an_appeal_or_request>Citizen_(United_Kingdom),	<Police_(Cambodia)>
<Praise_or_endorse>Ministry_(Jordan),	<Ministry_(Jordan)>
<Consult>United_Arab_Emirates,	<Medical_Personnel_(Peru)>
<Consult>Uhuru_Muigai_Kenyatta,	<Government_Official_(Afghanistan)>
<Make_a_visit>South_Sudan,	<James_Wani_Igga>
<Consult>Riek_Machar,	<Iran>
<Make_a_visit>Iran,	<South_Sudan>
<Make_an_appeal_or_request>China,	<Iran>
<Express_intent_to_meet_or_negotiate>Mikhail_Margelov,	<Ivan_Gasparovic>
<Praise_or_endorse>Military_(France),	<Al-Shabaab>
<Make_an_appeal_or_request>Verkhovna_Rada,	<Armed_Gang_(Egypt)>
<Consult>Yannis_Stournaras,	<North_Atlantic_Treaty_Organization>
<Consult>Media_Personnel_(Chile),	<Bolivia>
<Use_conventional_military_force>Citizen_(Nigeria),	<Main_Opposition_(South_Africa)>
<Demand>Interim_Government_(Thailand),<Consult>Kittiratt_Na-Ranong,<Impose_administrative_sanctions>Thailand,	<Asylum_Seeker_(Sudan)>
<Make_a_visit>European_Central_Bank,	<Labor_Union_(Nigeria)>
<Provide_humanitarian_aid>Citizen_(Cote_d'Ivoire),	<Oluṣẹgun_Ọbasanjọ>
<Make_an_appeal_or_request>Citizen_(United_Kingdom),	<Foreign_Affairs_(United_States)>
<Make_a_visit>Serbia,	<Labor_and_Employment_Ministry_(Bahrain)>
<Consult>Cristina_Fernández_de_Kirchner,	<Abu_Sayyaf>
<Engage_in_negotiation>Ethiopia,	<Morocco>
<Make_an_appeal_or_request>Citizen_(India),	<Court_Judge_(Mexico)>
<Make_a_visit>Iran,	<Armed_Band_(Lebanon)>
<Consult>Iran,	<Combatant_(Islamic_State_of_Iraq_and_the_Levant)>
<Praise_or_endorse>South_Korea,<Express_intent_to_meet_or_negotiate>China,	<Main_Opposition_(South_Africa)>
<Express_intent_to_meet_or_negotiate>John_Kerry,<Make_a_visit>France,<Express_intent_to_meet_or_negotiate>Envoy_(United_States),	<Armenia>
<Express_intent_to_engage_in_diplomatic_cooperation_(such_as_policy_support)>Other_Authorities_/_Officials_(Egypt),<Make_an_appeal_or_request>North_Korea,<Make_an_appeal_or_request>Blogger_(China),	<South_Korea>
<Consult>Foreign_Affairs_(Russia),	<Foreign_Affairs_(India)>
<Make_empathetic_comment>Japan,	<European_Parliament>
<Express_intent_to_meet_or_negotiate>United_Arab_Emirates,<Make_a_visit>Aïchatou_Mindaoudou_Souleymane,<Make_a_visit>Japan,<Criticize_or_denounce>North_Korea,<Express_intent_to_engage_in_diplomatic_cooperation_(such_as_policy_support)>Business_(Uruguay),	<Angola>
<Praise_or_endorse>Citizen_(Yemen),	<Military_(France)>
<Make_an_appeal_or_request>Children_(Zimbabwe),	<Industry_(South_Africa)>
<Host_a_visit>Jean-Yves_Le_Drian,<Meet_at_a_'third'_location>China,<Consult>Ministry_(Iran),<Express_intent_to_cooperate>Japan,<Host_a_visit>Antonis_Samaras,<Engage_in_negotiation>China,<Consult>Foreign_Affairs_(Ukraine),<Express_intent_to_engage_in_diplomatic_cooperation_(such_as_policy_support)>Iran,<Engage_in_diplomatic_cooperation>Iraq,<Host_a_visit>Foreign_Affairs_(Russia),<Host_a_visit>Foreign_Affairs_(United_States),<Use_conventional_military_force>Citizen_(Mali),<Criticize_or_denounce>François_Hollande,<Host_a_visit>Barack_Obama,<Consult>François_Hollande,<Express_intent_to_meet_or_negotiate>Iran,	<Boko_Haram>
<Consult>Julie_Bishop,	<Fiji>
<Express_intent_to_meet_or_negotiate>Military_(France),<Make_a_visit>Elizabeth_II,<Make_a_visit>China,	<Boko_Haram>
<Criticize_or_denounce>Citizen_(Nigeria),	<Emilio_Pérez_Touriño>
<Criticize_or_denounce>Angela_Merkel,	<United_Arab_Emirates>
<Consult>Political_Parties_(Italy),	<Military_Personnel_-_Special_(Kenya)>
<Accuse>Men_(Kenya),	<Militia_(Kenya)>
<Praise_or_endorse>Sushil_Koirala,	<Member_of_the_Judiciary_(Nigeria)>
<Reject_proposal_to_meet_discuss_or_negotiate>Citizen_(Nigeria),<Accuse>Chibuike_Rotimi_Amaechi,<Make_pessimistic_comment>Citizen_(Nigeria),	<Medical_Personnel_(Nigeria)>
<Demand_de-escalation_of_military_engagement>Armed_Rebel_(Pakistan),	<Activist_(United_States)>
<Praise_or_endorse>Government_(France),	<Angola>
<Impose_administrative_sanctions>South_Africa,<Consult>Member_of_the_Judiciary_(South_Africa),	<Defense_/_Security_Ministry_(Nigeria)>
<Engage_in_material_cooperation>Hezbollah,<Criticize_or_denounce>Yasir_Arafat,<Accuse>Armed_Rebel_(Syria),	<Armed_Rebel_(Syria)>
<Sign_formal_agreement>Afghanistan,	<Civic_Group_(Kenya)>
<Return_release_person(s)>Detainee_(Venezuela),	<Office_of_the_United_Nations_High_Commissioner_for_Human_Rights>
<Make_a_visit>Seyoum_Mesfin,	<Police_(United_States)>
<Give_ultimatum>Police_(Ukraine),	<Cobra_Matata>
<Accuse>Armed_Rebel_(Syria),	<Priest_(Holy_See_(Vatican_City_State))>
<Engage_in_negotiation>People_Associated_with_the_Opposition_(Ukraine),	<Police_(Senegal)>
<Criticize_or_denounce>Planning_Commission_(India),	<Education_Ministry_(France)>
<Criticize_or_denounce>Finance_/_Economy_/_Commerce_/_Trade_Ministry_(Japan),<Cooperate_economically>Japan,	<Japan>
<Accuse>Citizen_(Kenya),<Express_intent_to_engage_in_diplomatic_cooperation_(such_as_policy_support)>Citizen_(Kenya),	<James_Ongwae>
<Consult>High_Commission_for_Refugees,	<Militant_(Yemen)>
<Express_intent_to_cooperate>Democratic_Party,<Consult>Kim_Hwang_Sik,	<Defense_/_Security_Ministry_(India)>
<Arrest_detain_or_charge_with_legal_action>Criminal_(Guatemala),	<Bala_Abdulkadir_Mohammed>
<Arrest_detain_or_charge_with_legal_action>Citizen_(Nigeria),	<Court_Judge_(Mexico)>
<Demand>Citizen_(Zambia),	<Nurse_(United_States)>
<Consult>Labor_and_Employment_Ministry_(Bahrain),	<Business_(Bahrain)>
<Praise_or_endorse>Abdiweli_Shaykh_Ahmad,	<Joaquim_Barbosa>
<Express_intent_to_meet_or_negotiate>Treasury/Finance_Ministry_(Saudi_Arabia),	<Boko_Haram>
<Make_an_appeal_or_request>Company_-_Owner_or_Operator_(United_Arab_Emirates),	<Abdel_Fattah_Al-Sisi>
<Praise_or_endorse>Japan,<Consult>Akhilesh_Yadav,<Rally_opposition_against>Citizen_(India),	<Company_-_Owner_or_Operator_(India)>
<Host_a_visit>Canada,	<Police_(United_States)>
<Criticize_or_denounce>Citizen_(Nigeria),<Praise_or_endorse>Treasury/Finance_Ministry_(Nigeria),	<Ministry_(Nigeria)>
<Appeal_for_economic_cooperation>Businessperson_(Pakistan),	<Benazir_Bhutto>
<Appeal_for_intelligence>Police_(Ukraine),	<Verkhovna_Rada>
<Express_intent_to_meet_or_negotiate>Other_Authorities_/_Officials_(Namibia),	<Tahirul_Qadri>
<Make_a_visit>City_Mayor_(Netherlands),	<Media_(Saudi_Arabia)>
<Praise_or_endorse>Government_(Syria),<Host_a_visit>Mohammad_Javad_Zarif,	<Armed_Rebel_(Syria)>
<Engage_in_diplomatic_cooperation>Other_Authorities_/_Officials_(Chad),<Express_intent_to_provide_humanitarian_aid>Refugee_(Democratic_Republic_of_Congo),	<Iran>
<Consult>Police_(Malaysia),	<City_Mayor_(Italy)>
<Host_a_visit>Cabinet_/_Council_of_Ministers_/_Advisors_(United_States),	<Vytenis_Povilas_Andriukaitis>
<Demand>Citizen_(Thailand),	<Franklin_Drilon>
<Make_an_appeal_or_request>Morocco,<Make_a_visit>South_Sudan,<Accuse_of_human_rights_abuses>Uhuru_Muigai_Kenyatta,	<China>
<Make_an_appeal_or_request>Government_(Pakistan),	<Tahirul_Qadri>
<Accuse_of_crime_corruption>Abdelilah_Benkirane,	<New_Zealand>
<Accuse>Citizen_(India),	<Freedom_Fighter_(Zambia)>
<Make_a_visit>Tanzania,	<Canadian_Armed_Forces>
<Use_unconventional_violence>Police_(Yemen),	<Hubert_Alexander_Ingraham>
<Arrest_detain_or_charge_with_legal_action>Men_(South_Africa),	<Japan>
<Express_intent_to_meet_or_negotiate>Uhuru_Muigai_Kenyatta,<Express_intent_to_provide_economic_aid>Malawi,	<Colombia>
<Consult>Agence_France-Presse,	<Armenia>
<Host_a_visit>North_Korea,<Consult>China,<Host_a_visit>Nabih_Berri,<Engage_in_diplomatic_cooperation>South_Korea,<Consult>Foreign_Affairs_(Lebanon),<Engage_in_diplomatic_cooperation>Mexico,<Sign_formal_agreement>China,<Host_a_visit>Central_Intelligence_Agency,<Express_intent_to_meet_or_negotiate>Philippines,<Praise_or_endorse>Hezbollah,<Express_intent_to_meet_or_negotiate>China,<Engage_in_negotiation>Bertie_Ahern,<Host_a_visit>Portugal,<Consider_policy_option>Militant_(Syria),<Engage_in_diplomatic_cooperation>Thailand,<Host_a_visit>Jack_Straw,<Engage_in_negotiation>Kofi_Annan,	<Morteza_Sarmadi>
<Expel_or_deport_individuals>Militant_(Iraq),<Host_a_visit>Nuri_al-Maliki,<Cooperate_militarily>Iran,<Host_a_visit>Sergey_Viktorovich_Lavrov,	<National_Alliance_(Iraq)>
<Arrest_detain_or_charge_with_legal_action>Criminal_(Ireland),<Express_intent_to_meet_or_negotiate>Iran,	<Army_Personnel_(Egypt)>
<Make_an_appeal_or_request>Police_(Gambia),	<Villager_(Hong_Kong)>
<Consult>Head_of_Government_(Afghanistan),	<Government_(Pakistan)>
<Use_unconventional_violence>Hezbollah,	<Security_Council_(Russia)>
<Praise_or_endorse>Romania,	<Găgăuzia>
<Make_a_visit>Iran,<Express_intent_to_meet_or_negotiate>Iran,	<National_Youth_Service>
<Consult>William_Ruto,<Express_intent_to_cooperate>Citizen_(Tanzania),	<Tanzania>
<Praise_or_endorse>Government_(Sudan),	<Guerrilla_(El_Salvador)>
<Engage_in_diplomatic_cooperation>China,<Express_intent_to_cooperate>Foreign_Affairs_(United_States),<Meet_at_a_'third'_location>North_Korea,<Engage_in_symbolic_act>Royal_Administration_(Japan),<Host_a_visit>Foreign_Affairs_(United_States),<Host_a_visit>Yoshitaka_Shindo,<Host_a_visit>Barack_Obama,	<China>
<Bring_lawsuit_against>Lawyer/Attorney_(Australia),	<Owen_Ellington>
<Make_a_visit>France,	<France>
<Consult>Iran,	<South_Korea>
<Protest_violently_riot>Police_(Israel),	<Okey_Wali>
<Consult>Le_Luong_Minh,<Make_a_visit>China,<Make_a_visit>Kuwait,<Threaten_to_reduce_or_stop_aid>National_Coalition_for_Syrian_Revolutionary_and_Opposition_Forces,<Engage_in_negotiation>John_Baird,<Express_intent_to_meet_or_negotiate>Arseniy_Yatsenyuk,<Express_intent_to_meet_or_negotiate>Evangelos_Venizelos,<Express_intent_to_meet_or_negotiate>China,<Meet_at_a_'third'_location>Nasser_Judeh,<Engage_in_symbolic_act>Media_Personnel_(Africa),<Discuss_by_telephone>Sergey_Viktorovich_Lavrov,<Consult>Nasser_Judeh,<Make_an_appeal_or_request>Foreign_Affairs_(Russia),<Make_an_appeal_or_request>Other_Authorities_/_Officials_(Egypt),	<Iran>
<Make_an_appeal_or_request>Assemblies_(Nigeria),	<Government_(Nigeria)>
<Discuss_by_telephone>Nuri_al-Maliki,<Make_an_appeal_or_request>Iraq,<Make_a_visit>Shimon_Peres,	<Daniel_Ortega>
<Praise_or_endorse>Daniel_Scioli,	<East_African_Community>
<Make_an_appeal_or_request>Government_(Venezuela),	<Mexico>
<Deny_responsibility>Miguel_Ángel_Osorio_Chong,	<Police_(Hong_Kong)>
<Engage_in_negotiation>Frank_Bainimarama,<Consult>Frank_Bainimarama,	<Barack_Obama>
<Criticize_or_denounce>Protester_(Thailand),	<Protester_(Thailand)>
<Express_intent_to_meet_or_negotiate>Mulatu_Teshome,	<Government_(Jamaica)>
<Meet_at_a_'third'_location>Salil_Shetty,	<Hubert_Alexander_Ingraham>
<Demand_diplomatic_cooperation_(such_as_policy_support)>South_Korea,<Praise_or_endorse>Military_(North_Korea),<Appeal_for_diplomatic_cooperation_(such_as_policy_support)>South_Korea,<Criticize_or_denounce>Lee_Myung_Bak,	<North_Korea>
<Make_an_appeal_or_request>Citizen_(Thailand),	<Bala_Abdulkadir_Mohammed>
<Express_intent_to_meet_or_negotiate>Ministry_(Romania),	<Romania>
<Make_a_visit>Iran,<Consult>Mohammad_Javad_Zarif,	<Armed_Gang_(Benin)>
<Host_a_visit>Catherine_Ashton,<Host_a_visit>Mohammad_Javad_Zarif,	<Pavel_Gubarev>
<Make_an_appeal_or_request>Citizen_(India),	<Lawyer/Attorney_(Uganda)>
<Sign_formal_agreement>Ministry_(Kyrgyzstan),	<Media_Personnel_(United_States)>
<Praise_or_endorse>Military_Personnel_-_Special_(Tunisia),	<Kisii>
<Sign_formal_agreement>Cambodia,<Express_intent_to_engage_in_diplomatic_cooperation_(such_as_policy_support)>China,	<Al_Arabiya>
<Consult>Kim_Yong_Il,	<Farm_Worker_(Nigeria)>
<Make_an_appeal_or_request>Other_Authorities_/_Officials_(Russia),	<ITAR_TASS>
<Accuse>John_Kerry,	<Military_Personnel_(Libya)>
<Make_a_visit>Iran,	<Murtala_Nyako>
<Make_a_visit>Iran,<Consult>Adli_Mansour,	<Party_Member_(Afghanistan)>
<Praise_or_endorse>Kevin_Rudd,	<Police_(Australia)>
<Ease_administrative_sanctions>Protester_(Turkey),	<Efkan_Ala>
<Praise_or_endorse>Awami_(People's)_League,	<Military_(Mexico)>
<Express_intent_to_provide_economic_aid>Student_(Iraq),	<Government_(Bahamas)>
<Make_empathetic_comment>Armenia,	<Rupiah_Banda>
<Retreat_or_surrender_militarily>Other_Authorities_/_Officials_(Venezuela),	<Civil_Guard>
<Make_an_appeal_or_request>Citizen_(Australia),	<Employee_(Kenya)>
<Express_intent_to_meet_or_negotiate>Xi_Jinping,<Consult>Ma_Ying_Jeou,	<Employee_(India)>
<Appeal_for_policy_change>Other_Authorities_/_Officials_(China),	<China>
<Express_intent_to_meet_or_negotiate>South_Korea,<Appeal_for_diplomatic_cooperation_(such_as_policy_support)>North_Korea,	<China>
<Praise_or_endorse>Citizen_(Nigeria),	<Oman>
<Consult>Court_Judge_(India),	<François_Hollande>
<Host_a_visit>Zhang_Dejiang,<Make_a_visit>China,	<Media_(Saudi_Arabia)>
<Consult>Abdullah_Gül,<Consult>Justice_and_Development_Party,<Criticize_or_denounce>Justice_and_Development_Party,	<Business_(South_Korea)>
<Make_a_visit>China,	<China>
<Make_a_visit>Iran,	<Iran>
<Host_a_visit>Bahrain,<Host_a_visit>Barack_Obama,<Arrest_detain_or_charge_with_legal_action>Men_(Malaysia),	<Armed_Rebel_(Ukraine)>
<Consult>Will_Hodgman,	<Police_(Australia)>
<Consult>Gilgit–Baltistan,<Make_optimistic_comment>China,	<Media_(Pakistan)>
<Make_an_appeal_or_request>Indigenous_People_(India),	<Haiti>
<Criticize_or_denounce>John_Kerry,<Praise_or_endorse>France,	<Iran>
<Host_a_visit>John_Kerry,	<Government_(Venezuela)>
<Criticize_or_denounce>Nuri_al-Maliki,	<Iraq>
<Host_a_visit>Special_Rapporteurs_of_the_United_Nations,	<Criminal_(Jamaica)>
<Accuse>Citizen_(India),<Consult>Member_of_Parliament_(India),	<Fidesz>
<Consult>Imran_Khan,<Discuss_by_telephone>Media_Personnel_(Pakistan),	<Mauritania>
<Engage_in_symbolic_act>Men_(Philippines),	<Head_of_Government_(Ukraine)>
<Praise_or_endorse>Protester_(Thailand),	<Military_(Philippines)>
<Consult>Evo_Morales,	<Criminal_(Kosovo)>
<Consult>John_Kerry,	<Naval_(China)>
<Praise_or_endorse>International_Monetary_Fund,	<Armed_Rebel_(Mali)>
<Make_an_appeal_or_request>Protester_(Ukraine),	<Main_Opposition_(Turkey)>
<Consider_policy_option>Iran,	<Iran>
<Reject>Citizen_(Nigeria),	<City_Mayor_(New_Zealand)>
<Praise_or_endorse>Iran,	<Office_of_the_United_Nations_High_Commissioner_for_Human_Rights>
<Praise_or_endorse>Iran,	<South_Korea>
<Reduce_relations>Citizen_(India),<Investigate>Citizen_(India),	<Head_of_Government_(India)>
<Consult>Party_Member_(Iran),	<Ministry_(Iran)>
<Praise_or_endorse>Police_(Jordan),	<Police_(Jordan)>
<Make_an_appeal_or_request>Ombudsman_(Thailand),	<Congress_(Philippines)>
<Yield>South_Africa,<Reject>Men_(South_Africa),	<South_Africa>
<Arrest_detain_or_charge_with_legal_action>Joaquim_Barbosa,	<Education_Ministry_(France)>
<Sexually_assault>Santhal_Tribe,<Use_unconventional_violence>Women_(Denmark),	<South_Sudan>
<Reject>African_Christian_Democratic_Party,<Use_unconventional_violence>Police_(South_Africa),<Demand_economic_aid>Police_(South_Africa),	<Businessperson_(Turkey)>
<Use_unconventional_violence>Lee_Rigby,	<Michael_Sata>
<Host_a_visit>Japan_Self-Defense_Forces,<Arrest_detain_or_charge_with_legal_action>Sinaloa_Cartel,<Reject>Government_(Mexico),<Arrest_detain_or_charge_with_legal_action>Drug_Gang_(Mexico),	<Indigenous_People_(India)>
<Praise_or_endorse>Chishimba_Kambwili,	<Court_Judge_(Iraq)>
<Make_an_appeal_or_request>Foreign_Affairs_(United_States),<Host_a_visit>John_Kerry,<Host_a_visit>Benjamin_Netanyahu,	<United_Arab_Emirates>
<Conduct_suicide_car_or_other_non-military_bombing>Iraq,	<Military_Personnel_-_Special_(Nigeria)>
<Make_an_appeal_or_request>Citizen_(India),	<James_Wani_Igga>
<Threaten>Citizen_(United_Kingdom),	<Government_(Ecuador)>
<Mobilize_or_increase_armed_forces>Congo,<Declare_truce_ceasefire>African_Union,	<Military_(Central_African_Republic)>
<Mobilize_or_increase_armed_forces>Mexico,	<Insurgent_(Thailand)>
<Arrest_detain_or_charge_with_legal_action>Moro_Islamic_Liberation_Front,	<Criminal_(Philippines)>
<fight_with_small_arms_and_light_weapons>Men_(Russia),	<Nationalist_Movement_Party>
<Occupy_territory>South_Sudan,	<Imad_Mugniyah>
<Arrest_detain_or_charge_with_legal_action>Citizen_(Cote_d'Ivoire),	<Media_(Africa)>
<Threaten>Citizen_(India),	<Dalbir_Singh>
<Make_an_appeal_or_request>Armed_Forces_of_Sao_Tome_and_Principe,	<Ministry_(Croatia)>
<Arrest_detain_or_charge_with_legal_action>Citizen_(India),<Use_conventional_military_force>Terrorist_(Boko_Haram),	<Sergey_Viktorovich_Lavrov>
<Use_conventional_military_force>Myanmar,	<Head_of_Government_(Greece)>
<Express_intent_to_meet_or_negotiate>China,<Express_intent_to_engage_in_diplomatic_cooperation_(such_as_policy_support)>Islam_Karimov,	<Jan_Kohout>
<Investigate>Government_(Belgium),	<Government_Official_(Afghanistan)>
<Criticize_or_denounce>Public_Prosecutor_(Brazil),	<Fumio_Kishida>
<Consult>Milos_Zeman,	<Mustafa_Dzhemilev>
<Make_a_visit>Ethiopia,	<Western_Sahara>
<Consult>Omar_Abdullah,	<Hamas>
<Consult>France,<Make_optimistic_comment>Iran,<Praise_or_endorse>Mohammad_Javad_Zarif,	<Mehr_News_Agency>
<Make_pessimistic_comment>Citizen_(Nigeria),<Host_a_visit>Attahiru_Dalhatu_Bafarawa,	<Other_Authorities_/_Officials_(Nigeria)>
<Make_an_appeal_or_request>Women_(Senegal),	<Foreign_Affairs_(Honduras)>
<Make_an_appeal_or_request>Police_(South_Africa),	<South_Africa>
<Praise_or_endorse>Government_(Sudan),	<Government_(Sudan)>
<Engage_in_negotiation>Defense_/_Security_Ministry_(China),	<Employee_(Philippines)>
<Make_an_appeal_or_request>Head_of_Government_(Mauritania),	<Militia_(Kenya)>
<Make_a_visit>Iran,	<James_Ongwae>
<Reject>Cabinet_/_Council_of_Ministers_/_Advisors_(United_States),<Consult>Ministry_(Iran),<Consult>Sebastian_Kurz,<Consult>Adil_Abdul-Mahdi,<Consult>Pier_Ferdinando_Casini,<Consult>Foreign_Affairs_(Latvia),<Host_a_visit>Sergey_Viktorovich_Lavrov,<Make_a_visit>Gurbanguly_Berdymukhammedov,<Consult>Other_Authorities_/_Officials_(Russia),<Consult>Head_of_Government_(Turkmenistan),<Make_empathetic_comment>Iran,	<Iran>
<Consult>Ashraf_Ghani_Ahmadzai,	<Afghanistan>
<Demand>Media_(Liberia),	<North_Atlantic_Treaty_Organization>
<Host_a_visit>Middle_East,<Express_intent_to_engage_in_diplomatic_cooperation_(such_as_policy_support)>Iran,	<Tamerlan_Tsarnaev>
<Make_an_appeal_or_request>Morgan_Tsvangirai,	<Government_(Ecuador)>
<Praise_or_endorse>Adebisi_Akande,	<Air_Force_(Iraq)>
<Make_an_appeal_or_request>Citizen_(Nigeria),	<Lawyer/Attorney_(Czech_Republic)>
<Engage_in_symbolic_act>Citizen_(Nigeria),	<Sheikh_Ali_Salman>
<Demand>North_Korea,<Sign_formal_agreement>Malaysia,	<Police_(United_States)>
<Consider_policy_option>Military_(Lebanon),	<Iran>
<Consult>John_Kerry,	<Simon_Khaya_Moyo>
<Reject>Iran,<Meet_at_a_'third'_location>John_Kerry,	<Armed_Gang_(United_States)>
<Use_unconventional_violence>National_Anti-Corruption_Commission_(Thailand),	<Liberal_Party_(Canada)>
<Torture>Asylum_Seeker_(Indonesia),	<Militant_(Taliban)>
<Consult>Vietnam,	<Vietnam>
<Make_a_visit>Mohamed_Ould_Abdel_Aziz,	<Middle_East>
<Make_an_appeal_or_request>Assemblies_(Nigeria),	<Government_(South_Africa)>
<Engage_in_negotiation>Barack_Obama,<Consult>Barack_Obama,	<Mahinda_Rajapaksa>
<Make_pessimistic_comment>Catherine_Ashton,<Make_a_visit>Romania,<Use_conventional_military_force>Islamic_Extremist_Group_(Afghanistan),	<Military_(Russia)>
<Engage_in_diplomatic_cooperation>South_Korea,<Host_a_visit>China,<Demand>Iran,<Praise_or_endorse>Kim_Jong-Un,<Host_a_visit>Foreign_Affairs_(United_States),<Host_a_visit>Military_Personnel_(South_Korea),<Host_a_visit>Kim_Jong-Un,	<South_Korea>
<Accuse>Legislature_(Iraq),<Consult>Ministry_(Russia),	<Iraq>
<Demonstrate_or_rally>Healthcare_Facility_(Venezuela),	<François_Hollande>
<Consult>Royal_Administration_(Nigeria),	<Sule_Lamido>
<Engage_in_diplomatic_cooperation>Iran,	<Poland>
<Decline_comment>Media_(India),	<Muhammadu_Buhari>
<Use_unconventional_violence>Kiev_police,	<Ethiopia>
<Praise_or_endorse>Leopoldo_López,	<Defense_/_Security_Ministry_(South_Sudan)>
<Meet_at_a_'third'_location>Nabih_Berri,<Make_a_visit>Morocco,	<Muhammadu_Buhari>
<Impose_restrictions_on_political_freedoms>China,	<Provincial_Officials_(China)>
<Consult>Domestic_Affairs_(Greece),	<Liberals_(Canada)>
<Confiscate_property>Tanzania,	<Raúl_Castro>
<Arrest_detain_or_charge_with_legal_action>Yamoussa_Camara,	<People_Associated_with_the_Opposition_(Albania)>
<Express_intent_to_release_persons_or_property>Citizen_(Mauritania),	<Mohamed_Ould_Abdel_Aziz>
<Investigate>Military_Personnel_-_Special_(Mexico),	<Héctor_Beltrán_Leyva>
<Appeal_for_diplomatic_cooperation_(such_as_policy_support)>Citizen_(Nigeria),	<Government_(Nigeria)>
<Investigate>Criminal_(Somalia),	<National_Council_for_Peace_and_Order_of_Thailand>
<Impose_administrative_sanctions>Infosys,	<Foreign_Affairs_(India)>
<Express_intent_to_cooperate>Citizen_(Venezuela),<Arrest_detain_or_charge_with_legal_action>Leopoldo_López,	<Social_Democratic_Union>
<Consult>Milos_Zeman,	<Nurse_(United_States)>
<Consult>Employee_(India),	<Police_(United_States)>
<Accuse>People_Associated_with_the_Opposition_(Ukraine),	<City_Mayor_(Ukraine)>
<Consult>Anders_Borg,	<Associated_Press>
<Consult>Jacob_J._Lew,	<Portugal>
<Consult>Nationalist_Movement_Party,	<Attacker_(Palestinian_Territory_Occupied)>
<Consult>Catherine_Ashton,<Reject>Verkhovna_Rada,	<Abdel_Fattah_Al-Sisi>
<Make_an_appeal_or_request>China,	<Medical_Personnel_(Switzerland)>
<Host_a_visit>Jonathan_Greenert,<Criticize_or_denounce>China,<Engage_in_negotiation>South_Korea,<Arrest_detain_or_charge_with_legal_action>Secret_Agent_(Philippines),<Arrest_detain_or_charge_with_legal_action>Criminal_(Philippines),	<China>
<Make_an_appeal_or_request>Military_(Vietnam),	<Vietnam>
<Consult>France,<Express_intent_to_meet_or_negotiate>France,	<Kazakhstan>
<Express_intent_to_meet_or_negotiate>Citizen_(Australia),<fight_with_small_arms_and_light_weapons>Citizen_(Australia),<Confiscate_property>Citizen_(Australia),<Accuse>Criminal_(Australia),	<Sue-Ellen_Kovack>
<Use_conventional_military_force>Employee_(Bosnia_and_Herzegovina),	<Justicialist_Party>
<Arrest_detain_or_charge_with_legal_action>Women_(Burundi),	<Fula_people>
<Use_conventional_military_force>Cambodia,	<Media_(Saudi_Arabia)>
<Mobilize_or_increase_police_power>Canada,	<Canadian_Armed_Forces>
<Investigate>People_Associated_with_the_Opposition_(Croatian_Democratic_Union),<Express_accord>Mladen_Bajić,	<Criminal_(Mexico)>
<Use_tactics_of_violent_repression>Protester_(Egypt),<Praise_or_endorse>Company_-_Owner_or_Operator_(Egypt),	<Agence_France-Presse>
<Use_tactics_of_violent_repression>Citizen_(Greece),	<Education_(Greece)>
<Arrest_detain_or_charge_with_legal_action>Women_(Hong_Kong),	<Protester_(Hong_Kong)>
<Arrest_detain_or_charge_with_legal_action>Children_(Israel),	<Republican_People's_Party>
<Use_conventional_military_force>Men_(Kenya),<Reject>Citizen_(Kenya),<Arrest_detain_or_charge_with_legal_action>Men_(Kenya),	<Immigrants_(Ethiopia)>
<Arrest_detain_or_charge_with_legal_action>Citizen_(Kyrgyzstan),	<Armed_Band_(Afghanistan)>
<Arrest_detain_or_charge_with_legal_action>Citizen_(Namibia),	<Business_(New_Zealand)>
<Engage_in_negotiation>Scotland_Yard,	<Fighter_Bomber_(Iran)>
<Arrest_detain_or_charge_with_legal_action>Employee_(Saudi_Arabia),<Use_conventional_military_force>Citizen_(Saudi_Arabia),	<Armed_Gang_(Saudi_Arabia)>
<fight_with_small_arms_and_light_weapons>Citizen_(Sudan),	<Dmitry_Anatolyevich_Medvedev>
<Physically_assault>Protester_(Ukraine),<Arrest_detain_or_charge_with_legal_action>Citizen_(Georgia),<Criticize_or_denounce>Protester_(Ukraine),<Use_conventional_military_force>Protester_(Ukraine),<Consult>Protester_(Ukraine),<Praise_or_endorse>European_Parliament,<Use_tactics_of_violent_repression>Protester_(Ukraine),<Praise_or_endorse>Svoboda,	<Protester_(Ukraine)>
<fight_with_small_arms_and_light_weapons>Tamerlan_Tsarnaev,<fight_with_small_arms_and_light_weapons>Citizen_(United_Kingdom),	<Volvo>
<Arrest_detain_or_charge_with_legal_action>Citizen_(Yemen),	<Armed_Rebel_(Yemen)>
<Consult>Barack_Obama,	<South_Korea>
<Host_a_visit>Umar_al_Bashir,	<Daily_Monitor>
<Praise_or_endorse>Abdel_Fattah_Al-Sisi,	<National_Police>
<Consult>Prajin_Jantong,	<Insurgent_(Thailand)>
<Consult>Radio_France_Internationale,<Accuse>Madagascar,	<Defense_/_Security_Ministry_(Azerbaijan)>
<Provide_humanitarian_aid>Boko_Haram,	<Business_(Russia)>
<Obstruct_passage_block>Afghanistan,	<Police_(Jamaica)>
<Protest_violently_riot>Police_(Bosnia_and_Herzegovina),	<Police_(Egypt)>
<Protest_violently_riot>Police_(Egypt),	<Pope_Francis>
<Consult>Tokon_Mamytov,	<Algirdas_Butkevičius>
<Demonstrate_or_rally>Political_Parties_(Pakistan),	<Guerrilla_(Revolutionary_Armed_Forces_of_Colombia)>
<Obstruct_passage_block>Thailand,<Reduce_or_stop_humanitarian_assistance>Thailand,<Protest_violently_riot>Thailand,<Impose_restrictions_on_political_freedoms>Thailand,<Demand>Citizen_(Thailand),<Demand_change_in_leadership>Citizen_(Thailand),<Ease_military_blockade>Thailand,	<Thaksin_Shinawatra>
<Obstruct_passage_block>Justice_Department/Ministery_(Ukraine),<Defy_norms_law>Police_(Ukraine),<Demonstrate_or_rally>Police_(Ukraine),<Protest_violently_riot>Police_(Ukraine),<Obstruct_passage_block>Party_of_Regions,	<Secret_Agent_(Russia)>
<Demonstrate_or_rally>Police_(Yemen),	<Sikh_(India)>
<Praise_or_endorse>Ministry_(Brazil),	<Hubert_Alexander_Ingraham>
<Criticize_or_denounce>Morocco,	<Criminal_(Australia)>
<Engage_in_negotiation>Ramalinga_Reddy,	<National_Alliance_(Iraq)>
<Host_a_visit>Ibrahim_Boubacar_Keïta,<Praise_or_endorse>National_Coalition_for_Syrian_Revolutionary_and_Opposition_Forces,<Engage_in_diplomatic_cooperation>Ireland,	<Abdel_Fattah_Al-Sisi>
<Threaten>Citizen_(India),	<Secretariat_(Egypt)>
<Praise_or_endorse>Pervez_Musharraf,	<Pavel_Gubarev>
<Arrest_detain_or_charge_with_legal_action>Citizen_(Bangladesh),	<Criminal_(Jamaica)>
<Praise_or_endorse>Government_(Nigeria),	<Government_(Nigeria)>
<Make_an_appeal_or_request>Military_(Myanmar),	<Barack_Obama>
<Give_ultimatum>Party_of_Regions,	<Ethiopia>
<Reduce_relations>Kristiina_Ojuland,	<Media_Personnel_(Thailand)>
<Express_intent_to_meet_or_negotiate>Ethiopia,<Demonstrate_or_rally>Ethiopia,	<Mustafa_Dzhemilev>
<Consult>Government_(Syria),	<Military_(Vietnam)>
<Express_intent_to_meet_or_negotiate>Nationalist_Movement_Party,	<Antonio_Guerrero_Rodríguez>
<Threaten>Reserve_Personnel_(China),<Provide_humanitarian_aid>Fishermen_(Japan),	<China>
<Arrest_detain_or_charge_with_legal_action>Citizen_(Kyrgyzstan),	<Government_Official_(Afghanistan)>
<Consult>Mohammad_Javad_Zarif,	<Kuwait>
<Sign_formal_agreement>Louise_Mushikiwabo,	<Lawyer/Attorney_(Belgium)>
<Use_unconventional_violence>Uganda_People's_Defence_Force,	<Umar_al_Bashir>
<Host_a_visit>Evangelos_Venizelos,<Host_a_visit>China,<Host_a_visit>Victoria_Nuland,	<Austria_Press_Agency>
<Praise_or_endorse>Head_of_Government_(Egypt),	<South_Korea>
<Engage_in_symbolic_act>Waseda_University,	<Nicos_Anastasiades>
<Host_a_visit>Transparency_International,	<Police_(Australia)>
<Make_an_appeal_or_request>North_Korea,	<South_Korea>
<Consult>Abdel_Fattah_Al-Sisi,	<UN_Security_Council>
<Praise_or_endorse>Activist_(Western_Sahara),	<Armenia>
<Criticize_or_denounce>People_Associated_with_the_Opposition_(National_Coalition_for_Syrian_Revolutionary_and_Opposition_Forces),	<Lawyer/Attorney_(Colombia)>
<Consult>John_Kerry,<Engage_in_negotiation>John_Kerry,<Consult>Kapil_Sibal,<Consult>Cabinet_/_Council_of_Ministers_/_Advisors_(United_States),	<Election_Commission_(India)>
<Make_a_visit>China,	<Member_of_Parliament_(Ukraine)>
<Rally_opposition_against>Military_Personnel_(Afghanistan),<Engage_in_negotiation>Military_Personnel_-_Special_(United_States),	<Afghanistan>
<Consult>Mohammad_Javad_Zarif,	<Head_of_Government_(India)>
<Arrest_detain_or_charge_with_legal_action>Criminal_(Philippines),	<Joaquim_Barbosa>
<Accuse>Citizen_(United_Kingdom),	<Civic_Group_(Argentina)>
<Host_a_visit>Food_and_Agriculture_Organization,<Host_a_visit>Vesna_Pusić,	<International_Monetary_Fund>
<Consult>Abdel_Fattah_Al-Sisi,	<Military_(Russia)>
<Engage_in_negotiation>Mohammad_Javad_Zarif,<Consult>Sabah_Khaled_Al-Hamad_Al-Sabah,<Consult>Mohammad_Javad_Zarif,<Praise_or_endorse>John_Kerry,<Express_intent_to_meet_or_negotiate>Børge_Brende,<Express_intent_to_meet_or_negotiate>North_Atlantic_Treaty_Organization,<Make_an_appeal_or_request>France,<Consult>Foreign_Affairs_(United_States),<Express_intent_to_meet_or_negotiate>Foreign_Affairs_(Russia),	<ITAR_TASS>
<Make_a_visit>South_Sudan,	<Police_(United_States)>
<Consult>Marwan_Charbel,	<Franklin_Drilon>
<Reject>Bangladesh_Nationalist_Party,<Make_an_appeal_or_request>Bangladesh_Nationalist_Party,<Consult>Abdul_Hamid,<Praise_or_endorse>Citizen_(Bangladesh),<Make_an_appeal_or_request>North_Korea,	<Member_of_Parliament_(Bangladesh)>
<Consult>Barack_Obama,	<Pope_Francis>
<Consult>Bahrain,	<Poland>
<Consult>Company_-_Owner_or_Operator_(Italy),	<Defense_/_Security_Ministry_(Nigeria)>
<Make_an_appeal_or_request>Ministry_(South_Africa),<Arrest_detain_or_charge_with_legal_action>Police_(South_Africa),<Ease_administrative_sanctions>Julius_Malema,	<China>
<Reject>North_Korea,<Engage_in_diplomatic_cooperation>Iran,<Engage_in_negotiation>North_Korea,<Host_a_visit>John_Kerry,<Praise_or_endorse>Legislature_(United_States),<Criticize_or_denounce>Party_Member_(Japan),<Sign_formal_agreement>North_Korea,<Engage_in_diplomatic_cooperation>North_Korea,	<North_Korea>
<Make_an_appeal_or_request>Riek_Machar,<Host_a_visit>Daily_Monitor,<Host_a_visit>Uhuru_Muigai_Kenyatta,<Express_intent_to_cooperate>Sudan,<Reduce_or_break_diplomatic_relations>Sudan,	<Riek_Machar>
<Provide_humanitarian_aid>Citizen_(Nigeria),	<Militia_(Kenya)>
<Express_intent_to_engage_in_diplomatic_cooperation_(such_as_policy_support)>Chen_Deming,	<Owen_Ellington>
<Use_unconventional_violence>Police_(Cote_d'Ivoire),	<Court_Judge_(Lebanon)>
<Use_unconventional_violence>Police_(Kosovo),	<Business_(Peru)>
<Criticize_or_denounce>Thailand,	<Medical_Personnel_(Switzerland)>
<Criticize_or_denounce>Citizen_(Venezuela),<Demonstrate_or_rally>Government_(Venezuela),	<Kivutha_Kibwana>
<Provide_humanitarian_aid>Citizen_(Sudan),<Arrest_detain_or_charge_with_legal_action>Criminal_(Central_African_Republic),<Host_a_visit>Iraq,<Praise_or_endorse>South_Sudan,<Host_a_visit>Agence_France-Presse,	<Benazir_Bhutto>
<Use_conventional_military_force>South_Sudan,	<Armenia>
<Express_intent_to_engage_in_diplomatic_cooperation_(such_as_policy_support)>Afghanistan,<Sign_formal_agreement>Iran,	<Turkish_Airlines>
<Arrest_detain_or_charge_with_legal_action>Monastery_(Thailand),	<Cambodia>
<Consult>Business_(Netherlands),	<Independence_Party>
<Make_an_appeal_or_request>Citizen_(Kyrgyzstan),	<China>
<Criticize_or_denounce>Foreign_Affairs_(United_States),	<Maldives>
<Praise_or_endorse>Head_of_Government_(Egypt),	<Armed_Gang_(Egypt)>
<Consult>Thongsing_Thammavong,	<Other_Authorities_/_Officials_(Switzerland)>
<Make_a_visit>France,	<Employee_(Kuwait)>
<Accuse_of_crime_corruption>Oluṣẹgun_Ọbasanjọ,	<Oluṣẹgun_Ọbasanjọ>
<Provide_humanitarian_aid>Citizen_(Turkey),	<Police_(Indonesia)>
<Engage_in_negotiation>Royal_Administration_(Saudi_Arabia),	<Treasury/Finance_Ministry_(Czech_Republic)>
<Praise_or_endorse>South_Sudan,<Express_intent_to_meet_or_negotiate>Iran,	<Sudan>
<Provide_aid>Government_(Kenya),	<Political_Parties_(Fiji)>
<Express_intent_to_meet_or_negotiate>Philippines,	<Student_(Hong_Kong)>
<Mobilize_or_increase_armed_forces>South_Sudan,	<Thief_(India)>
<Appeal_for_diplomatic_cooperation_(such_as_policy_support)>Lawmaker_(Central_African_Republic),	<National_Youth_Service>
<Make_a_visit>Congo,<Make_a_visit>Popular_Congress,	<Sudan>
<Sign_formal_agreement>Iran,<Consult>High_Ranking_Military_Personnel_(United_Arab_Emirates),	<Raúl_Castro>
<Consult>Christiana_Anyanwu,	<Independence_Party>
<Praise_or_endorse>Indigenous_People_(India),	<Guinea>
<Discuss_by_telephone>Simonetta_Sommaruga,	<Civic_Group_(Croatia)>
<Make_an_appeal_or_request>Kim_Jong-Un,	<Arnaud_Montebourg>
<Consult>Victoria_Nuland,<Make_an_appeal_or_request>Ministry_(Romania),	<Romania>
<Sign_formal_agreement>Barack_Obama,	<Police_(Indonesia)>
<Criticize_or_denounce>Citizen_(India),	<Protester_(Hong_Kong)>
<Demonstrate_or_rally>Thailand,	<Military_(Mali)>
<Make_an_appeal_or_request>Party_Member_(Taiwan),	<Government_(Kenya)>
<Make_an_appeal_or_request>Head_of_Government_(Ukraine),<Consult>Government_Official_(United_States),<Consult>John_Kerry,	<Yulia_Tymoshenko>
<Consult>Ma_Ying_Jeou,<Consult>John_Kerry,<Consult>Milos_Zeman,<Consult>Evo_Morales,	<China>
<Sign_formal_agreement>Yasir_Arafat,	<Court_Judge_(Mexico)>
<Criticize_or_denounce>Minister_Patnaik,	<Aam_Aadmi_Party>
<Engage_in_symbolic_act>Religion_(China),	<Xi_Jinping>
<Consult>Arseniy_Yatsenyuk,<Express_intent_to_cooperate>Angela_Merkel,	<Armed_Gang_(Lebanon)>
<Consult>John_Brennan,	<Head_of_Government_(Latvia)>
<Make_a_visit>Viktor_Orban,	<China>
