sentences	sensitiveAttr
<Demand>Government_(Pakistan),	<Iran>
<Host_a_visit>China,	<Jean-Yves_Le_Drian>
<Express_intent_to_meet_or_negotiate>Japan,	<Maldives>
<Engage_in_diplomatic_cooperation>Kuwait,<Consult>Industry_(Turkey),<Criticize_or_denounce>Police_(Syria),	<Businessperson_(Turkey)>
<Sign_formal_agreement>Government_(Nigeria),	<Activist_(United_States)>
<Arrest_detain_or_charge_with_legal_action>Citizen_(Indonesia),	<Yulia_Tymoshenko>
<Demonstrate_or_rally>Foreign_Affairs_(Russia),	<Government_(Bahamas)>
<Discuss_by_telephone>Agence_France-Presse,	<Thief_(India)>
<Make_a_visit>Burundi,	<Veterans_(Croatia)>
<Make_an_appeal_or_request>Citizen_(Benin),	<Moro_National_Liberation_Front>
<Make_a_visit>Kuwait,<Express_intent_to_cooperate>Citizen_(Australia),	<Police_(Egypt)>
<Demand>Citizen_(International),<Engage_in_diplomatic_cooperation>Iran,<Engage_in_negotiation>Sayed_Fazlollah_Wahidi,<Make_empathetic_comment>Mohammed_Qasim_Fahim,<Consult>Iran,	<Armed_Band_(Afghanistan)>
<Meet_at_a_'third'_location>Angola,	<Lawyer/Attorney_(Colombia)>
<Discuss_by_telephone>China,<Make_pessimistic_comment>Haiti,	<Hamas>
<Make_an_appeal_or_request>Citizen_(India),	<Xi_Jinping>
<Accuse>Justice_and_Development_Party,	<Defense_/_Security_Ministry_(China)>
<Engage_in_negotiation>Cho_Tai-young,	<Security_Council_(Russia)>
<Use_conventional_military_force>Militant_(Somalia),	<Police_(Dominican_Republic)>
<Discuss_by_telephone>Movement_of_Society_for_Peace,	<Qatar>
<Consult>Iran,<Accuse>Foreign_Affairs_(Austria),	<Oman>
<Consult>Gideon_Sa'ar,	<Haiti>
<Make_an_appeal_or_request>Citizen_(United_Kingdom),<Reject>Citizen_(United_Kingdom),	<Party_Member_(United_Kingdom)>
<Consult>Edgars_Rinkevics,	<Somali_National_Army>
<Consult>Dmitry_Anatolyevich_Medvedev,	<Defense_/_Security_Ministry_(Ukraine)>
<Praise_or_endorse>France,	<Social_Democratic_Party_(Lithuania)>
<Make_an_appeal_or_request>Other_Authorities_/_Officials_(Swaziland),	<Scientist_(Tajikistan)>
<Make_a_visit>Japan,	<Julie_Bishop>
<Consult>Xi_Jinping,<Express_intent_to_cooperate>Barack_Obama,<Express_intent_to_meet_or_negotiate>Poland,	<Madeleine_Albright>
<Sign_formal_agreement>Sergey_Viktorovich_Lavrov,	<Congo>
<Consult>Angela_Merkel,<Express_intent_to_meet_or_negotiate>Yulia_Tymoshenko,	<Coalition_of_the_Radical_Left>
<Apologize>Media_(South_Africa),	<Associated_Press>
<Make_a_visit>China,	<Franklin_Drilon>
<Threaten>Men_(Argentina),	<Tea_Banh>
<Use_unconventional_violence>Citizen_(India),	<Foreign_Affairs_(Lebanon)>
<Use_unconventional_violence>Military_(Lebanon),	<Employee_(India)>
<Carry_out_suicide_bombing>Military_Personnel_-_Special_(Afghanistan),<Use_unconventional_violence>Military_Personnel_-_Special_(Afghanistan),<Carry_out_suicide_bombing>Election_Commission_(Afghanistan),<Use_unconventional_violence>Afghanistan,	<Western_Sahara>
<Use_unconventional_violence>Indigenous_People_(Nigeria),	<AvtoVAZ>
<Use_unconventional_violence>Military_(Lebanon),<Impose_administrative_sanctions>Military_Personnel_(Libya),<Abduct_hijack_or_take_hostage>Central_Bank_of_Libya,	<Court_Judge_(Iraq)>
<Use_unconventional_violence>Children_(Thailand),<Use_unconventional_violence>Citizen_(Thailand),	<Media_Personnel_(Thailand)>
<Use_unconventional_violence>Middle_East,	<United_Progressive_Alliance>
<Retreat_or_surrender_militarily>Citizen_(Yemen),	<Ri_Su_Yong>
<Praise_or_endorse>Government_(Syria),	<Cobra_Matata>
<fight_with_small_arms_and_light_weapons>Citizen_(Venezuela),	<Member_of_Parliament_(Romania)>
<Demand>Police_(Ukraine),	<Military_(Russia)>
<Demonstrate_or_rally>Other_Authorities_/_Officials_(Russia),<Express_intent_to_meet_or_negotiate>North_Atlantic_Treaty_Organization,<Consult>Barack_Obama,<Make_a_visit>Pope_Francis,<Demand>Defense_/_Security_Ministry_(Ukraine),<Consult>Joseph_Robinette_Biden,	<Head_of_Government_(Ukraine)>
<Demand>Political_Parties_(Burkina_Faso),	<Detainee_(Lebanon)>
<Consult>Arseniy_Yatsenyuk,<Discuss_by_telephone>Lawyer/Attorney_(Colombia),	<Armed_Gang_(Egypt)>
<Accuse>Police_(Jordan),	<Medical_Personnel_(Jordan)>
<Use_unconventional_violence>Military_Personnel_-_Special_(Afghanistan),	<Legislature_(Libya)>
<Make_an_appeal_or_request>Citizen_(Turkey),	<Ministry_(Thailand)>
<Sign_formal_agreement>Stephane_Le_Foll,	<Australia_Greens>
<Express_intent_to_engage_in_diplomatic_cooperation_(such_as_policy_support)>Haiti,	<Haiti>
<Criticize_or_denounce>United_Arab_Emirates,<Engage_in_diplomatic_cooperation>Iran,<Criticize_or_denounce>Nuri_al-Maliki,<Reduce_or_break_diplomatic_relations>Qatar,<Host_a_visit>Sheikh_Ahmed_Abdullah,	<Republican_People's_Party>
<Consult>Barack_Obama,	<Foreign_Affairs_(United_States)>
<Conduct_strike_or_boycott>Awami_(People's)_League,<Threaten>Awami_(People's)_League,<Use_unconventional_violence>Militant_(Bangladesh),	<Awami_(People's)_League>
<Consult>Umar_al_Bashir,<Consult>Benjamin_Netanyahu,<Consult>Elizabeth_II,<Accuse>Benjamin_Netanyahu,<Make_a_visit>Malaysia,<Express_intent_to_cooperate>Angela_Merkel,<Express_intent_to_meet_or_negotiate>Citizen_(Belgium),<Praise_or_endorse>Veterans_(Philippines),<Make_a_visit>South_Korea,<Express_intent_to_cooperate_economically>Iran,<Appeal_for_diplomatic_cooperation_(such_as_policy_support)>International_Monetary_Fund,<Make_a_visit>Japan,<Host_a_visit>Benjamin_Netanyahu,<Consult>Head_of_Government_(South_Korea),<Express_intent_to_meet_or_negotiate>Head_of_Government_(Ukraine),<Express_intent_to_meet_or_negotiate>Pope_Francis,<Discuss_by_telephone>Angela_Merkel,<Consult>Pope_Francis,<Make_an_appeal_or_request>North_Atlantic_Treaty_Organization,<Express_intent_to_cooperate_militarily>Philippines,<Consult>François_Hollande,<Make_a_visit>North_Korea,<Meet_at_a_'third'_location>Xi_Jinping,<Consult>UN_Security_Council,<Consult>Cabinet_/_Council_of_Ministers_/_Advisors_(Holy_See_(Vatican_City_State)),<Consult>Pietro_Parolin,<Appeal_for_political_reform>International_Monetary_Fund,<Praise_or_endorse>Military_Personnel_-_Special_(Afghanistan),<Express_intent_to_provide_material_aid>South_Korea,<Make_a_visit>Philippines,<Praise_or_endorse>Benjamin_Netanyahu,	<North_Atlantic_Treaty_Organization>
<Express_intent_to_cooperate>Yair_Lapid,<Accuse>Iran,<Consult>John_Kerry,<Reject_proposal_to_meet_discuss_or_negotiate>Government_(Palestinian_Territory_Occupied),<Consult>Joseph_Robinette_Biden,	<John_Kerry>
<Make_an_appeal_or_request>Citizen_(India),	<Police_(Hong_Kong)>
<Make_an_appeal_or_request>Government_(Nigeria),	<Uhuru_Muigai_Kenyatta>
<Make_an_appeal_or_request>Keriako_Tobiko,	<National_Police>
<Abduct_hijack_or_take_hostage>Education_(Nigeria),<Use_conventional_military_force>Education_(Nigeria),	<Government_(Nigeria)>
<Arrest_detain_or_charge_with_legal_action>Citizen_(Venezuela),	<Armed_Band_(Lebanon)>
<Accuse>Citizen_(Nigeria),<Make_a_visit>Head_of_Government_(Nigeria),	<Israeli_Defense_Forces>
<Sign_formal_agreement>Tanzania,	<Armed_Rebel_(Syria)>
<Consult>Labor_and_Employment_Ministry_(Bahrain),	<Head_of_Government_(Bahrain)>
<Consult>Ministry_(Croatia),	<Military_Personnel_(Yemen)>
<Consult>Benjamin_Netanyahu,	<National_Youth_Service>
<Consult>Ministry_(Thailand),	<Other_Authorities_/_Officials_(Hong_Kong)>
<Consult>Akitaka_Saiki,<Engage_in_negotiation>Sergey_Viktorovich_Lavrov,<Make_pessimistic_comment>Militant_(Ukraine),<Consult>Sergey_Viktorovich_Lavrov,<Discuss_by_telephone>Sergey_Viktorovich_Lavrov,<Consult>Foreign_Affairs_(Russia),<Meet_at_a_'third'_location>Sergey_Viktorovich_Lavrov,	<Fumio_Kishida>
<Express_intent_to_engage_in_diplomatic_cooperation_(such_as_policy_support)>Citizen_(Malaysia),	<Thailand>
<Express_intent_to_meet_or_negotiate>Citizen_(Australia),	<Milos_Zeman>
<Make_an_appeal_or_request>Foreign_Affairs_(Russia),<Mobilize_or_increase_armed_forces>Romania,<Express_intent_to_meet_or_negotiate>France,	<Liberal_Party_(Canada)>
<Consult>Iurie_Leanca,	<City_Mayor_(Italy)>
<Appeal_for_diplomatic_cooperation_(such_as_policy_support)>Japan,	<Head_of_Government_(Nigeria)>
<Engage_in_negotiation>Mohammad_Javad_Zarif,<Consult>Dissident_(Iran),<Meet_at_a_'third'_location>John_Kerry,<Engage_in_negotiation>Iran,<Make_a_visit>Iran,<Consult>Adli_Mansour,<Express_intent_to_cooperate>Government_(Nigeria),<Consult>Head_of_Government_(Kosovo),<Express_intent_to_meet_or_negotiate>Iran,	<Iran>
<Consult>Defense_/_Security_Ministry_(United_States),<Accuse>Japan,	<Military_(China)>
<Consult>Jeroen_Dijsselbloem,	<Foreign_Affairs_(Syria)>
<Host_a_visit>Shimon_Peres,<Make_a_visit>Malaysia,<Praise_or_endorse>Xi_Jinping,<Engage_in_diplomatic_cooperation>Myanmar,<Make_optimistic_comment>Pavlo_Sheremeta,<Cooperate_economically>France,<Host_a_visit>Chuck_Hagel,<Host_a_visit>Xi_Jinping,<Make_an_appeal_or_request>Police_(Malaysia),<Express_intent_to_cooperate_economically>South_Korea,<Host_a_visit>Governor_(Japan),<Host_a_visit>North_Korea,<Grant_diplomatic_recognition>Cameroon,<Appeal_for_intelligence>International_Government_Organizations,<Engage_in_diplomatic_cooperation>New_Zealand,<Host_a_visit>Naval_(Bangladesh),<Criticize_or_denounce>Yoshitaka_Shindo,<Make_a_visit>François_Hollande,<Make_a_visit>France,<Host_a_visit>Japan,<Praise_or_endorse>Myanmar,<Appeal_for_intelligence>Malaysia,	<Afghanistan>
<Criticize_or_denounce>Citizen_(Nigeria),	<Defense_/_Security_Ministry_(Nigeria)>
<Consult>Chang_Wanquan,<Praise_or_endorse>Military_(Mongolia),<Threaten>China,<Make_a_visit>China,<Praise_or_endorse>Sergey_Kuzhugetovich_Shoygu,<Make_a_visit>Guatemala,<Consult>Defense_/_Security_Ministry_(Malaysia),<Praise_or_endorse>Japan,	<Iran>
<Reduce_relations>Member_of_Parliament_(Australia),	<Military_(China)>
<Make_an_appeal_or_request>Children_(Taiwan),	<Justin_Trudeau>
<Make_an_appeal_or_request>European_Parliament,	<Ethiopia>
<Express_intent_to_meet_or_negotiate>Goh_Chok_Tong,	<Police_(Kenya)>
<Appeal_for_easing_of_administrative_sanctions>Oversight_Court_(Bulgaria),	<Civil_Guard>
<Make_an_appeal_or_request>Indigenous_People_(Cote_d'Ivoire),<Accuse>Medical_Personnel_(Cote_d'Ivoire),	<Pope_Francis>
<Criticize_or_denounce>Andrej_Babis,	<Ukrinform>
<Make_optimistic_comment>North_Atlantic_Treaty_Organization,	<City_Mayor_(Croatia)>
<Demonstrate_or_rally>Foreign_Affairs_(Russia),	<Business_(Canada)>
<Physically_assault>Election_Commission_(India),<Demand>Ethnic_Group_(India),<Accuse>Thief_(India),<Complain_officially>Employee_(India),<Accuse>Election_Commission_(India),<Reduce_relations>Labor_Union_(India),<Make_an_appeal_or_request>Oommen_Chandy,<Accuse>Media_(India),<Express_intent_to_meet_or_negotiate>AK_Singh,<Accuse>Employee_(India),<Accuse>Baljinder_Singh,<Make_an_appeal_or_request>Election_Commission_(India),<Criticize_or_denounce>Military_Personnel_-_Special_(India),	<Education_(Nigeria)>
<Accuse>Military_Personnel_-_Special_(Kenya),<Express_intent_to_meet_or_negotiate>Ethiopia,	<Volvo>
<Use_unconventional_violence>Citizen_(Indonesia),<Criticize_or_denounce>Malaysia,<Make_optimistic_comment>Malaysia,	<Foreign_Affairs_(Chile)>
<Criticize_or_denounce>Government_(Mauritania),	<Ukrinform>
<Use_unconventional_violence>Farm_Worker_(Nigeria),<Demand>Mukhtar_Ramalan_Yero,<Use_unconventional_violence>Company_-_Owner_or_Operator_(Nigeria),<Make_an_appeal_or_request>Muslim_(Nigeria),<Make_empathetic_comment>Government_(Nigeria),<Make_an_appeal_or_request>Other_Authorities_/_Officials_(Nigeria),	<Employee_(Kuwait)>
<Use_unconventional_violence>Armed_Rebel_(Syria),	<Héctor_Beltrán_Leyva>
<Demonstrate_or_rally>Foreign_Affairs_(Russia),	<Defense_/_Security_Ministry_(Cyprus)>
<Demonstrate_or_rally>Student_(Sudan),<Accuse>Government_(Sudan),<Accuse>Sudan,<Engage_in_symbolic_act>Student_(Sudan),	<Head_of_Government_(Germany)>
<Demonstrate_or_rally>Justice_and_Development_Party,<Express_intent_to_meet_or_negotiate>Other_Authorities_/_Officials_(Turkey),	<Government_(France)>
<Accuse>Police_(Uganda),<Use_unconventional_violence>Uganda_People's_Defence_Force,	<Lawyer/Attorney_(Turkey)>
<Criticize_or_denounce>Alex_Salmond,<Use_unconventional_violence>Combatant_(Taliban),	<Member_of_Parliament_(Ukraine)>
<Rally_support_on_behalf_of>Detainee_(Venezuela),<Criticize_or_denounce>High_Ranking_Military_Personnel_(Venezuela),<Accuse>Militant_(Venezuela),<Criticize_or_denounce>Government_(Venezuela),<Criticize_or_denounce>Leopoldo_López,	<Military_(Lebanon)>
<Abduct_hijack_or_take_hostage>Governor_(Yemen),	<Volvo>
<Consult>Agustín_Rossi,	<Ireland>
<Accuse_of_human_rights_abuses>Head_of_Government_(Colombia),	<Militia_(Kenya)>
<Provide_aid>Philippines,	<Employee_(Philippines)>
<Make_an_appeal_or_request>Citizen_(Zambia),	<Party_Member_(Turkey)>
<Accuse>Governor_(Kenya),	<Criminal_(Argentina)>
<Consult>Tsai_Ing-wen,	<New_Zealand>
<Make_an_appeal_or_request>Legislature_(Lebanon),	<Michael_Sata>
<Use_unconventional_violence>Somali_National_Army,	<Congress_(Philippines)>
<Accuse>Government_(Pakistan),	<Military_(Philippines)>
<Accuse>Citizen_(India),	<Thief_(India)>
<Express_intent_to_meet_or_negotiate>South_Africa,<Engage_in_diplomatic_cooperation>Angola,	<Romania>
<Consult>Cristina_Fernández_de_Kirchner,	<Guy_Scott>
<Accuse>Citizen_(Nigeria),	<Morteza_Sarmadi>
<Consult>Benjamin_Netanyahu,	<Police_(Hong_Kong)>
<Make_a_visit>Romania,	<Student_(Tanzania)>
<Arrest_detain_or_charge_with_legal_action>Rafael_Correa,	<Sikh_(India)>
<Arrest_detain_or_charge_with_legal_action>Prem_Singh,<Ease_administrative_sanctions>Citizen_(India),	<Medical_Personnel_(India)>
<Reject>Citizen_(Nigeria),<Demand>Government_(Nigeria),<Demand>Citizen_(Nigeria),<Make_an_appeal_or_request>Government_(Nigeria),<Reject>State_Security_Service,	<Oversight_Court_(Nigeria)>
<Use_unconventional_violence>Citizen_(Brazil),	<Police_(Senegal)>
<Sexually_assault>Children_(Sudan),	<Moro_Islamic_Liberation_Front>
<Express_intent_to_cooperate>Justicialist_Party,<Express_intent_to_meet_or_negotiate>France,<Meet_at_a_'third'_location>Sergey_Viktorovich_Lavrov,	<Government_(Argentina)>
<Make_an_appeal_or_request>Congress_(United_States),<Make_a_visit>Tajikistan,	<Military_(China)>
<Make_a_visit>China,	<North_Korea>
<Make_an_appeal_or_request>Citizen_(Czech_Republic),	<Police_(Kenya)>
<Consult>Zaheerul_Islam,<Consult>Chaudhry_Nisar_Ali_Khan,	<Sudan>
<Make_an_appeal_or_request>Company_-_Owner_or_Operator_(Zambia),	<Nadine_Heredia>
<Consult>Sudan,	<Legislature_(Turkey)>
<Make_an_appeal_or_request>Citizen_(Indonesia),	<Ministry_(Thailand)>
<Express_intent_to_meet_or_negotiate>Citizen_(Kyrgyzstan),	<Arseniy_Yatsenyuk>
<Make_a_visit>Wang_Yang,<Engage_in_negotiation>UN_Security_Council,	<France>
<Provide_aid>Healthcare_Facility_(Chad),	<Nurse_(France)>
<Reject>Women_(Australia),	<Ministry_(Croatia)>
<Praise_or_endorse>International_Government_Organizations,	<Businessperson_(Philippines)>
<Make_a_visit>Iran,	<Middle_East>
<Use_conventional_military_force>Police_(Egypt),	<Mauritius>
<Criticize_or_denounce>Party_Member_(Afghanistan),<Consult>Military_Personnel_(Afghanistan),	<Party_Member_(Afghanistan)>
<Accuse>Amit_Shah,<Appeal_for_economic_aid>Citizen_(India),<Criticize_or_denounce>Citizen_(India),<Investigate>Member_of_Parliament_(India),<Demand>Citizen_(India),	<Ministry_(Czech_Republic)>
<Demand>Citizen_(Nigeria),<Make_an_appeal_or_request>Citizen_(Nigeria),<Investigate>Government_(Nigeria),	<Government_(Nigeria)>
<Consult>Toomas_Hendrik_Ilves,	<Militant_(Boko_Haram)>
<fight_with_small_arms_and_light_weapons>Canada,	<Police_(Dominican_Republic)>
<Provide_humanitarian_aid>Citizen_(India),<Conduct_strike_or_boycott>Sharad_Pawar,	<Thief_(India)>
<Make_a_visit>Doctors_Without_Borders,	<UN_Security_Council>
<Consult>Treasury/Finance_Ministry_(Germany),	<Agence_France-Presse>
<Consult>China,	<Arseniy_Yatsenyuk>
<Make_an_appeal_or_request>Other_Authorities_/_Officials_(Nigeria),<Make_a_visit>Japan,<Consult>Raheel_Sharif,	<Iran>
<Consult>Morgan_Tsvangirai,	<Government_(Namibia)>
<Host_a_visit>John_Kerry,<Provide_humanitarian_aid>South_Sudan,	<Al-Shabaab>
<Make_an_appeal_or_request>Other_Authorities_/_Officials_(Turkey),	<Armed_Gang_(Egypt)>
<Consult>Laura_Boldrini,	<Mahinda_Rajapaksa>
<Express_intent_to_meet_or_negotiate>International_Court_of_Justice,	<Bolivia>
<Abduct_hijack_or_take_hostage>Citizen_(Nigeria),	<François_Hollande>
<Engage_in_symbolic_act>Military_(China),	<Civic_Group_(Croatia)>
<Employ_aerial_weapons>Sudan,	<Attack_Craft_(United_Kingdom)>
<Make_a_visit>Iran,<Praise_or_endorse>Iran,	<Government_(Austria)>
<Make_an_appeal_or_request>UN_Security_Council,	<Dzhokhar_Tsarnaev>
<Praise_or_endorse>Actor_(Hungary),	<Kuwait>
<Impose_restrictions_on_political_freedoms>Representatives_(Russia),<Express_intent_to_meet_or_negotiate>Iran,	<Edgars_Rinkevics>
<Threaten>Military_Personnel_(Libya),	<Other_Authorities_/_Officials_(Libya)>
<Rally_support_on_behalf_of>Student_(Iran),	<Oil_Tanker_(Bangladesh)>
<Make_an_appeal_or_request>France,	<Armenia>
<Consult>John_Kerry,<Criticize_or_denounce>Military_(Russia),	<Dmitry_Anatolyevich_Medvedev>
<Accuse>Sudan,<Make_an_appeal_or_request>Citizen_(Malaysia),<Consult>Massoud_Barzani,<Criticize_or_denounce>Japan,	<Angola>
<Express_intent_to_meet_or_negotiate>Iran,	<Emilio_Pérez_Touriño>
<Engage_in_diplomatic_cooperation>Niger,<Arrest_detain_or_charge_with_legal_action>Children_(France),<Sign_formal_agreement>Iran,<Express_intent_to_engage_in_diplomatic_cooperation_(such_as_policy_support)>China,<Arrest_detain_or_charge_with_legal_action>Youssef_Boutros_Ghali,<Arrest_detain_or_charge_with_legal_action>News_Editor_(France),<Employ_aerial_weapons>Combatant_(Al_Qaeda),<Cooperate_militarily>Military_(Niger),<Host_a_visit>Abdoulaye_Wade,<Express_intent_to_engage_in_diplomatic_cooperation_(such_as_policy_support)>Government_(Palestinian_Territory_Occupied),<Arrest_detain_or_charge_with_legal_action>Pascal_Simbikangwa,	<Boko_Haram>
<Investigate>Secretariat_for_the_Prevention_of_Drug_Abuse_and_Drug_Trafficking,	<Cristina_Fernández_de_Kirchner>
<Consult>John_Dramani_Mahama,<Host_a_visit>Xi_Jinping,	<Boko_Haram>
<Make_a_visit>Religion_(France),	<Government_(Kenya)>
<Praise_or_endorse>Police_(Gambia),	<City_Mayor_(Italy)>
<Consult>AB_Lithuanian_Gas,	<Interfax>
<Investigate>Police_(South_Africa),	<Canada>
<Express_intent_to_meet_or_negotiate>Alexei_Pushkov,	<Communist_Party_of_Bohemia_and_Moravia>
<Make_pessimistic_comment>Serbia,	<Government_(Nepal)>
<Praise_or_endorse>UN_Security_Council,	<Employee_(India)>
<Threaten>Ministry_(France),	<Arnaud_Montebourg>
<Praise_or_endorse>Military_(Italy),	<Sergey_Viktorovich_Lavrov>
<Refuse_to_yield>Medical_Personnel_(Nigeria),	<Medical_Personnel_(Nigeria)>
<Express_intent_to_engage_in_diplomatic_cooperation_(such_as_policy_support)>Pervez_Musharraf,<Consult>Tehrik-i-Taliban_Pakistan,<Reject>Pervez_Musharraf,	<Activist_(United_States)>
<Engage_in_negotiation>Business_(Panama),	<Foreign_Affairs_(Russia)>
<Engage_in_negotiation>Bank_(South_Africa),<Accuse>Foreign_Affairs_(Rwanda),	<Defense_/_Security_Ministry_(Nigeria)>
<Make_an_appeal_or_request>Government_(Sudan),	<Civic_Group_(Kenya)>
<Criticize_or_denounce>Citizen_(Venezuela),	<Office_of_the_United_Nations_High_Commissioner_for_Human_Rights>
<Express_intent_to_meet_or_negotiate>Businessperson_(Uzbekistan),	<Police_(Senegal)>
<Make_an_appeal_or_request>Population_(Angola),	<Angola>
<Appeal_for_economic_cooperation>Company_-_Owner_or_Operator_(India),	<Education_Ministry_(France)>
<Expel_or_deport_individuals>Citizen_(Kenya),<Consult>Media_(Africa),	<James_Ongwae>
<Make_an_appeal_or_request>Citizen_(Thailand),	<High_Commission_for_Refugees>
<Arrest_detain_or_charge_with_legal_action>Citizen_(Venezuela),	<Assemblies_(Nigeria)>
<Consult>Military_Personnel_(Yemen),	<Militant_(Yemen)>
<Make_an_appeal_or_request>Government_(Cote_d'Ivoire),	<Fula_people>
<Sign_formal_agreement>Morocco,	<Court_Judge_(Mexico)>
<Make_an_appeal_or_request>Government_(Nigeria),	<Head_of_Government_(Nigeria)>
<Consult>Ethiopia,	<Member_of_Parliament_(Bangladesh)>
<Consult>Ministry_(Angola),	<Foreign_Affairs_(Syria)>
<Make_a_visit>Abdul_Aziz,	<Other_Authorities_/_Officials_(Greece)>
<Make_an_appeal_or_request>Election_Commission_(India),<Reduce_relations>Ruling_Party_(India),<Make_an_appeal_or_request>Employee_(India),	<Company_-_Owner_or_Operator_(India)>
<Consult>Catherine_Ashton,	<Fiji>
<Praise_or_endorse>Government_(Nigeria),	<Ministry_(Nigeria)>
<Consider_policy_option>Afghanistan,	<Benazir_Bhutto>
<Make_pessimistic_comment>North_Atlantic_Treaty_Organization,	<Poland>
<Make_a_visit>Sudan,	<Qatar>
<Engage_in_negotiation>Barack_Obama,	<Indigenous_People_(South_Korea)>
<Engage_in_negotiation>Barack_Obama,<Make_a_visit>Barack_Obama,<Discuss_by_telephone>Joseph_Robinette_Biden,	<Verkhovna_Rada>
<Make_pessimistic_comment>Employee_(Sudan),<Criticize_or_denounce>Asylum_Seeker_(Kenya),	<Iran>
<Consult>Lilian_Samaniego,	<Government_(United_States)>
<Appeal_to_others_to_meet_or_negotiate>Barack_Obama,<Accuse_of_human_rights_abuses>Government_(Kenya),	<China>
<Consult>Vanguard,	<Education_(Nigeria)>
<Consult>Business_(Russia),	<Argentine_Naval_Prefecture>
<Praise_or_endorse>Media_(India),	<Ethnic_Group_(India)>
<Use_unconventional_violence>Afghanistan,	<Foreign_Affairs_(Lebanon)>
<Use_unconventional_violence>Citizen_(Yemen),	<Government_(Venezuela)>
<fight_with_small_arms_and_light_weapons>Citizen_(Thailand),	<Employee_(Iraq)>
<Arrest_detain_or_charge_with_legal_action>Citizen_(India),	<City_Mayor_(Ukraine)>
<Praise_or_endorse>Refugee_(Ethiopia),	<Police_(Sudan)>
<Consult>Angola,	<Colombia>
<Sign_formal_agreement>Poland,<Investigate>Ministry_(Iran),<Sign_formal_agreement>Justice_Department/Ministery_(Azerbaijan),<Host_a_visit>Javier_Solana,<Cooperate_economically>Japan,<Consult>Catherine_Ashton,<Host_a_visit>Mohammad_Javad_Zarif,<Host_a_visit>Foreign_Affairs_(Latvia),<Host_a_visit>South_Korea,<Sign_formal_agreement>European_Parliament,<Engage_in_negotiation>Barack_Obama,<Host_a_visit>Catherine_Ashton,<Host_a_visit>Sebastian_Kurz,<Express_intent_to_engage_in_diplomatic_cooperation_(such_as_policy_support)>Oman,<Consult>Kazakhstan,<Host_a_visit>Hossein_Salami,<Consult>Japan,	<Morteza_Sarmadi>
<Engage_in_negotiation>Aero_Vodochody,<Make_an_appeal_or_request>Iraqi_Islamic_Party,	<National_Alliance_(Iraq)>
<Host_a_visit>Alexis_Tsipras,	<Army_Personnel_(Egypt)>
<Consult>Environment_Department/Ministry_(Mauritania),	<Media_(Romania)>
<Appeal_for_intelligence>Government_(Kenya),	<Nurse_(United_States)>
<Use_unconventional_violence>Military_(Philippines),	<Daily_Monitor>
<Make_a_visit>Tatarstan,	<Police_(Egypt)>
<fight_with_small_arms_and_light_weapons>Children_(Palestinian_Territory_Occupied),	<Iran>
<Consult>Carlos_Pascual,	<Găgăuzia>
<Praise_or_endorse>Foreign_Affairs_(Slovakia),	<Fiji>
<Host_a_visit>Chuck_Hagel,<Deny_responsibility>China,<Express_intent_to_cooperate_economically>Myanmar,<Consult>Iran,<Host_a_visit>Hashim_Thaçi,<Host_a_visit>Hu_Deping,<Deny_responsibility>North_Korea,<Engage_in_negotiation>North_Korea,<Express_intent_to_meet_or_negotiate>China,<Criticize_or_denounce>Citizen_(South_Korea),<Engage_in_negotiation>South_Korea,<Complain_officially>North_Korea,<Express_intent_to_cooperate>North_Korea,<Engage_in_diplomatic_cooperation>Vietnam,<Reject>China,<Host_a_visit>Toomas_Hendrik_Ilves,	<China>
<Use_tactics_of_violent_repression>Simon_Ostrovsky,	<Police_(Philippines)>
<Consult>Canada,	<Civic_Group_(Argentina)>
<Make_a_visit>Guinea-Bissau,	<Ministry_(Czech_Republic)>
<Make_a_visit>Guatemala,	<Opposition_Supporter_(Venezuela)>
<Make_empathetic_comment>Romania,<Praise_or_endorse>Foreign_Affairs_(Ukraine),<Make_a_visit>Morocco,<Consult>Børge_Brende,<Consult>Sergey_Viktorovich_Lavrov,<Express_intent_to_meet_or_negotiate>Joseph_Kabila,<Make_pessimistic_comment>Militant_(Ukraine),<Engage_in_negotiation>Head_of_Government_(Pakistan),<Engage_in_negotiation>Benjamin_Netanyahu,<Express_intent_to_cooperate>Sergey_Viktorovich_Lavrov,<Make_pessimistic_comment>Sergey_Viktorovich_Lavrov,<Consult>Head_of_Government_(Pakistan),<Engage_in_negotiation>Arseniy_Yatsenyuk,<Express_intent_to_meet_or_negotiate>Catherine_Ashton,<Express_intent_to_meet_or_negotiate>Benjamin_Netanyahu,<Meet_at_a_'third'_location>Sergey_Viktorovich_Lavrov,	<Iran>
<Engage_in_negotiation>Antonis_Samaras,<Consult>Benjamin_Netanyahu,<Consult>Head_of_Government_(Latvia),<Meet_at_a_'third'_location>Toomas_Hendrik_Ilves,<Make_optimistic_comment>Arseniy_Yatsenyuk,<Consult>Arseniy_Yatsenyuk,<Consult>Milo_Djukanovic,	<Daniel_Ortega>
<Make_a_visit>Kuwait,<Engage_in_diplomatic_cooperation>Royal_Administration_(Spain),<Host_a_visit>Rafael_Correa,	<Sikh_(India)>
<Criticize_or_denounce>Government_(South_Africa),	<South_Africa>
<Sign_formal_agreement>Iran,	<Guy_Scott>
<Consult>Taavi_Rõivas,	<Government_(Jamaica)>
<Bring_lawsuit_against>Tim_Hudak,	<Police_(Bulgaria)>
<Consult>Iran,<Make_a_visit>Afghanistan,	<Government_(Nepal)>
<Accuse>South_Korea,<Reject_proposal_to_meet_discuss_or_negotiate>China,	<North_Korea>
<Consult>Juan_Carlos_I,<Host_a_visit>Hisham_Zaazou,<Host_a_visit>Abdullah_Gül,<Host_a_visit>Fayez_Tarawneh,<Reduce_or_break_diplomatic_relations>Qatar,<Host_a_visit>Umar_al_Bashir,	<Pavel_Gubarev>
<Consult>Businessperson_(Tunisia),	<Kisii>
<Consult>Thailand,	<Al_Arabiya>
<Accuse>Government_(Argentina),	<Cristina_Fernández_de_Kirchner>
<Engage_in_diplomatic_cooperation>Hezbollah,<Consult>Legislature_(Lebanon),	<Foreign_Affairs_(Russia)>
<Appeal_for_intelligence>Lawyer/Attorney_(Russia),	<ITAR_TASS>
<Express_intent_to_meet_or_negotiate>Iran,	<South_Sudan>
<Investigate>Veterans_(United_Kingdom),	<Party_Member_(Afghanistan)>
<Demonstrate_or_rally>Michael_Sata,	<Foreign_Affairs_(Syria)>
<Investigate>Detainee_(Argentina),	<Criminal_(Argentina)>
<Impose_restrictions_on_political_freedoms>Citizen_(Australia),<Accuse>Police_(Australia),	<Police_(Australia)>
<Discuss_by_telephone>Associated_Press,	<Criminal_(Australia)>
<Share_intelligence_or_information>Other_Authorities_/_Officials_(Egypt),	<Medical_Personnel_(Switzerland)>
<Make_an_appeal_or_request>Government_(Kenya),<Demand>Citizen_(Kenya),	<Uhuru>
<Investigate_crime_corruption>Court_Judge_(Romania),	<Ogbeni_Rauf_Aregbesola>
<Accuse_of_crime_corruption>Bureaucrat_(Turkey),	<Efkan_Ala>
<Threaten>Citizen_(United_Kingdom),<Arrest_detain_or_charge_with_legal_action>Military_(United_Kingdom),<Accuse>Men_(United_Kingdom),	<Frank_Bainimarama>
<Engage_in_symbolic_act>Citizen_(Germany),	<Justice_Department/Ministery_(Philippines)>
<Demand>Citizen_(Venezuela),	<Civil_Guard>
<Make_an_appeal_or_request>Citizen_(India),	<Employee_(India)>
<Make_optimistic_comment>Gina_McCarthy,<Express_intent_to_cooperate>Kuomintang,	<China>
<Express_intent_to_meet_or_negotiate>International_Monetary_Fund,<Praise_or_endorse>Medical_Personnel_(Madagascar),	<Nestor_Kirchner>
<Criticize_or_denounce>Antonis_Samaras,	<Head_of_Government_(Greece)>
<Accuse>Justice_and_Development_Party,	<Business_(South_Korea)>
<Engage_in_diplomatic_cooperation>Philippines,<Appeal_for_intelligence>China,<Engage_in_material_cooperation>Police_(United_States),	<Armed_Rebel_(Ukraine)>
<Express_intent_to_cooperate>Japan,	<Afghanistan>
<Demand>Government_(Nigeria),	<Immigrants_(Ethiopia)>
<Express_intent_to_meet_or_negotiate>France,	<Government_(Ecuador)>
<Consult>UN_Security_Council,	<Congo>
<Arrest_detain_or_charge_with_legal_action>Police_(Mauritania),	<Criminal_(Jamaica)>
<Arrest_detain_or_charge_with_legal_action>Criminal_(Mauritius),	<Ri_Su_Yong>
<Consult>Police_(Kenya),	<Businessperson_(Kenya)>
<Consult>Justicialist_Party,	<Criminal_(Argentina)>
<Praise_or_endorse>International_Monetary_Fund,	<France>
<Make_an_appeal_or_request>Citizen_(India),<Consult>Medical_Association_(India),	<Justice_Department/Ministery_(India)>
<Praise_or_endorse>Prabowo_Subianto,	<Jean-Yves_Le_Drian>
<Host_a_visit>Abdullah_bin_Nasser_bin_Khalifa_Al-Thani,	<Ministry_(Nigeria)>
<Praise_or_endorse>Ashraf_Ghani_Ahmadzai,	<Mehr_News_Agency>
<Consult>Catherine_Ashton,	<Iran>
<Demand>Citizen_(Australia),	<Criminal_(Australia)>
<Demonstrate_or_rally>Head_of_Government_(India),	<Head_of_Government_(India)>
<Demand>Iran,	<Ministry_(Iran)>
<Arrest_detain_or_charge_with_legal_action>Citizen_(Nigeria),	<Cristina_Fernández_de_Kirchner>
<Arrest_detain_or_charge_with_legal_action>Men_(South_Africa),<Demand>Thembelani_Waltermade_Nxesi,	<South_Africa>
<Demand>Citizen_(South_Korea),	<Armed_Forces_of_the_Republic_of_Armenia>
<Return_release_person(s)>Men_(Swaziland),	<Moro_Islamic_Liberation_Front>
<Praise_or_endorse>Government_(Venezuela),<Demand>Citizen_(Venezuela),	<Military_Personnel_(Mali)>
<Use_unconventional_violence>Hun_Sen,	<Tzipi_Livni>
<Physically_assault>Main_Opposition_(Georgia),	<Government_(Namibia)>
<Sexually_assault>Women_(Nepal),	<South_Sudan>
<Abduct_hijack_or_take_hostage>Employee_(Philippines),	<Other_Authorities_/_Officials_(Africa)>
<Use_unconventional_violence>City_Mayor_(Philippines),	<Industrial_/_Textiles_/_Mining_Ministry_(Azerbaijan)>
<Arrest_detain_or_charge_with_legal_action>Immigrants_(Guatemala),<Host_a_visit>François_Hollande,<Express_intent_to_cooperate>South_Korea,	<Indigenous_People_(India)>
<Criticize_or_denounce>Citizen_(United_Kingdom),	<Haaretz>
<Make_a_visit>Elizabeth_II,	<Ireland>
<Make_empathetic_comment>Citizen_(Nigeria),	<Court_Judge_(Iraq)>
<Praise_or_endorse>Andrej_Kiska,	<Other_Authorities_/_Officials_(Egypt)>
<Use_unconventional_violence>Citizen_(Nigeria),	<Police_(Jamaica)>
<Abduct_hijack_or_take_hostage>Citizen_(Nigeria),	<Nadine_Heredia>
<Use_unconventional_violence>Citizen_(Yemen),<Assassinate>Police_(Yemen),	<Police_(Australia)>
<Use_conventional_military_force>Armed_Band_(Central_African_Republic),	<Government_(Kenya)>
<Use_conventional_military_force>Combatant_(Mali),<Use_conventional_military_force>Jean-Yves_Le_Drian,	<Military_(Central_African_Republic)>
<Praise_or_endorse>Defense_/_Security_Ministry_(Italy),	<Gagik_Tsarukyan>
<Arrest_detain_or_charge_with_legal_action>Women_(Madagascar),	<Jakaya_Mrisho_Kikwete>
<Cooperate_militarily>France,	<Lawyer/Attorney_(Colombia)>
<Use_conventional_military_force>Islamic_Rebel_(Philippines),<Use_conventional_military_force>Philippines,	<Criminal_(Philippines)>
<Praise_or_endorse>Other_Authorities_/_Officials_(Russia),	<Nationalist_Movement_Party>
<Use_conventional_military_force>Citizen_(Thailand),<Express_intent_to_provide_military_aid>Citizen_(Thailand),	<Head_of_Government_(Latvia)>
<Praise_or_endorse>Armed_Rebel_(Syria),	<Combatant_(Turkey)>
<Use_conventional_military_force>Men_(United_Kingdom),	<Afghanistan>
<Use_conventional_military_force>Associated_Press,	<Martin_Spegelj>
<Consult>Military_(Lebanon),	<Haider_Al-Abadi>
<fight_with_small_arms_and_light_weapons>Citizen_(Nigeria),	<Militant_(Boko_Haram)>
<Praise_or_endorse>Governor_(Yemen),	<Attack_Craft_(United_Kingdom)>
<fight_with_small_arms_and_light_weapons>Attacker_(Afghanistan),<Use_conventional_military_force>Armed_Rebel_(Afghanistan),<Increase_military_alert_status>Afghanistan,	<Media_(Romania)>
<Consult>Majid_Takht_Ravanchi,	<Julie_Bishop>
<Praise_or_endorse>Andrej_Babis,	<Jan_Kohout>
<Make_an_appeal_or_request>Citizen_(Nigeria),	<Police_(Greece)>
<Make_an_appeal_or_request>Employee_(Afghanistan),	<Military_Personnel_-_Special_(Afghanistan)>
<Make_an_appeal_or_request>Citizen_(Malaysia),	<Malaysia>
<Consult>Envoy_(Spain),	<Insurgent_(Thailand)>
<Make_an_appeal_or_request>Labor_Union_(Nigeria),<Demand_meeting_negotiation>Citizen_(Nigeria),<Use_conventional_military_force>Citizen_(Nigeria),	<Other_Authorities_/_Officials_(Nigeria)>
<Consult>Abdullah_bin_Nasser_bin_Khalifa_Al-Thani,<Make_optimistic_comment>Iran,	<Legislature_(Turkey)>
<Express_intent_to_meet_or_negotiate>Mahinda_Rajapaksa,	<Businessperson_(Kenya)>
<Praise_or_endorse>Government_(Austria),<Consult>Elmar_Mammadyarov,	<Iran>
<Use_conventional_military_force>Military_(Philippines),	<Social_Democratic_Union>
<Sign_formal_agreement>Guinea,<Host_a_visit>Foreign_Affairs_(United_States),	<Tamerlan_Tsarnaev>
<Consult>Political_Parties_(Algeria),<Consult>Representatives_(Algeria),	<Civil_Guard>
<Make_an_appeal_or_request>Citizen_(Nigeria),	<Government_(Nigeria)>
<Make_a_visit>Angola,	<Air_Force_(Iraq)>
<Accuse>Government_(Nigeria),	<Boko_Haram>
<Abduct_hijack_or_take_hostage>Iran,	<Provincial_Officials_(China)>
<Consult>Joseph_Robinette_Biden,	<UN_Security_Council>
<Host_a_visit>Sergey_Kuzhugetovich_Shoygu,	<Police_(United_States)>
<Consult>Council_of_Representatives,	<Iran>
<Reduce_relations>Japan,	<Education_(Greece)>
<Make_a_visit>France,	<Head_of_Government_(Bahrain)>
<Consult>John_Kerry,	<Militant_(Taliban)>
<Express_intent_to_meet_or_negotiate>UN_Security_Council,	<Middle_East>
<Praise_or_endorse>Iran,	<Argentine_Naval_Prefecture>
<Make_a_visit>Poland,	<Al-Shabaab>
<Make_an_appeal_or_request>Military_(El_Salvador),	<Salvador_Sánchez_Cerén>
<Host_a_visit>Foreign_Affairs_(Ukraine),<Retreat_or_surrender_militarily>Afghanistan,<Engage_in_diplomatic_cooperation>Armenia,<Make_pessimistic_comment>Military_(Russia),<Engage_in_negotiation>Foreign_Affairs_(Georgia),	<Military_(Russia)>
<Reduce_relations>South_Korea,<Deny_responsibility>South_Korea,<Express_intent_to_cooperate>Japan,<Rally_support_on_behalf_of>UN_Security_Council,<Criticize_or_denounce>Citizen_(North_Korea),<Arrest_detain_or_charge_with_legal_action>Men_(United_States),<Engage_in_negotiation>Japan,<Criticize_or_denounce>Head_of_Government_(South_Korea),	<South_Korea>
<Consult>Government_Delegation_(Iraq),<Consult>Massoud_Barzani,	<Iraq>
<Consult>Iran,<Sign_formal_agreement>Iran,	<Poland>
<Make_an_appeal_or_request>Arseniy_Yatsenyuk,	<Pervez_Musharraf>
<Criticize_or_denounce>Media_(India),	<Revolutionary_Socialist_Party>
<Consult>Government_(Venezuela),	<Benjamin_Netanyahu>
<Accuse>Media_(India),	<Environmentalist_(France)>
<Increase_police_alert_status>China,	<Provincial_Officials_(China)>
<Arrest_detain_or_charge_with_legal_action>Police_(Egypt),<Accuse>Hamas,	<Police_(Egypt)>
<Consult>Foreign_Affairs_(Israel),	<National_Coalition_for_Syrian_Revolutionary_and_Opposition_Forces>
<Provide_humanitarian_aid>Guatemala,<Arrest_detain_or_charge_with_legal_action>Women_(Mexico),	<Héctor_Beltrán_Leyva>
<Provide_humanitarian_aid>Citizen_(Nigeria),	<Government_(Nigeria)>
<Engage_in_negotiation>Cabinet_/_Council_of_Ministers_/_Advisors_(Somalia),	<National_Council_for_Peace_and_Order_of_Thailand>
<Consult>Lawyer/Attorney_(Turkey),	<Hezbollah>
<Consult>Arseniy_Yatsenyuk,<Confiscate_property>Women_(Mexico),<Make_an_appeal_or_request>Citizen_(Kyrgyzstan),	<Foreign_Affairs_(India)>
<Refuse_to_yield>Afghanistan,	<Justice_Department/Ministery_(Philippines)>
<Make_an_appeal_or_request>Your_Party,	<Japan>
<Make_an_appeal_or_request>Citizen_(Turkey),	<Police_(Cambodia)>
<Make_an_appeal_or_request>Citizen_(Nigeria),	<Indigenous_People_(Nigeria)>
<Express_intent_to_meet_or_negotiate>Militant_(Taliban),	<Federal_Police>
<Engage_in_negotiation>Fumio_Kishida,<Make_empathetic_comment>Foreign_Affairs_(Malaysia),	<Ri_Su_Yong>
<Make_a_visit>High_Commission_(United_Kingdom),	<Media_Personnel_(Pakistan)>
<Meet_at_a_'third'_location>Employee_(Philippines),<Praise_or_endorse>Ministry_(Philippines),	<China>
<Host_a_visit>Qi_Jianguo,	<Vietnam>
<Consult>Ethiopia,	<Insurgent_(Thailand)>
<Consult>Daily_Trust,	<Chief_Court_Judge_(Zambia)>
<Reduce_relations>Foreign_Affairs_(Belarus),	<Kazakhstan>
<Return_release_person(s)>Citizen_(Australia),<Appeal_for_intelligence>Citizen_(Australia),	<Sue-Ellen_Kovack>
<Arrest_detain_or_charge_with_legal_action>Dmytro_Firtash,	<Head_of_Government_(Germany)>
<Use_conventional_military_force>Citizen_(Belgium),	<Lawyer/Attorney_(Belgium)>
<Impose_administrative_sanctions>Cambodia,	<Media_(Saudi_Arabia)>
<Criticize_or_denounce>Government_(Croatia),	<Criminal_(Mexico)>
<Investigate>Criminal_(Egypt),	<Agence_France-Presse>
<Abduct_hijack_or_take_hostage>Citizen_(Indonesia),<Investigate>Citizen_(Indonesia),	<New_Zealand>
<Investigate>Criminal_(Israel),<Arrest_detain_or_charge_with_legal_action>Israeli_Defense_Forces,	<Republican_People's_Party>
<Demand>Government_(Kenya),	<Immigrants_(Ethiopia)>
<Investigate>Engineer_(Malaysia),<Investigate>Citizen_(Malaysia),	<Malaysia>
<Arrest_detain_or_charge_with_legal_action>Citizen_(Mauritius),	<Party_Member_(Iraq)>
<Torture>Citizen_(Namibia),	<Business_(New_Zealand)>
<Use_conventional_military_force>Criminal_(Philippines),<Arrest_detain_or_charge_with_legal_action>Men_(Philippines),<Arrest_detain_or_charge_with_legal_action>Foreign_Affairs_(Italy),	<National_Police>
<Consult>Iran,	<Security_Council_(Russia)>
<Physically_assault>Women_(Afghanistan),	<Armed_Gang_(Saudi_Arabia)>
<Return_release_person(s)>Citizen_(Slovakia),	<Ri_Su_Yong>
<Investigate>South_Africa,	<Romania>
<Arrest_detain_or_charge_with_legal_action>Criminal_(South_Korea),<Provide_humanitarian_aid>Citizen_(South_Korea),<Investigate>Business_(South_Korea),	<Student_(South_Korea)>
<Use_conventional_military_force>Children_(Swaziland),	<Media_(Swaziland)>
<Investigate>Citizen_(Tanzania),<Arrest_detain_or_charge_with_legal_action>Citizen_(Kenya),	<Immigrants_(Sudan)>
<Praise_or_endorse>Volodymyr_Konstantynov,<Return_release_person(s)>Yulia_Tymoshenko,<Return_release_person(s)>Protester_(Ukraine),	<Protester_(Ukraine)>
<Make_an_appeal_or_request>Citizen_(Yemen),	<Armed_Rebel_(Yemen)>
<Consult>Abdel_Fattah_Al-Sisi,	<Government_(Kenya)>
<Use_conventional_military_force>Member_of_Parliament_(India),	<Employee_(Philippines)>
<Demand>Citizen_(Thailand),	<Insurgent_(Thailand)>
<Engage_in_negotiation>Party_Member_(Afghanistan),	<Abdullah_Abdullah>
<Consult>David_Choquehuanca,	<Police_(Israel)>
<Sexually_assault>Citizen_(Australia),	<Bernd_Lange>
<Demonstrate_or_rally>Police_(Egypt),	<Pope_Francis>
<Demonstrate_or_rally>Pervez_Musharraf,<Rally_support_on_behalf_of>Pervez_Musharraf,	<Guerrilla_(Revolutionary_Armed_Forces_of_Colombia)>
<Make_an_appeal_or_request>Military_(Thailand),<Appeal_for_diplomatic_cooperation_(such_as_policy_support)>Citizen_(Thailand),	<Thaksin_Shinawatra>
<Demonstrate_for_policy_change>Justice_and_Development_Party,	<National_Alliance_(Iraq)>
<Consult>Al_Jazeera,<Criticize_or_denounce>Kuwait,	<Abdel_Fattah_Al-Sisi>
<Consult>Didier_Burkhalter,	<Mustafa_Dzhemilev>
<Make_a_visit>Student_(Lebanon),	<Court_Judge_(Lebanon)>
<Make_an_appeal_or_request>Citizen_(India),	<Secretariat_(Egypt)>
<Make_a_visit>Government_(Venezuela),	<City_Mayor_(Indonesia)>
<Consult>Media_(Pakistan),	<Guy_Scott>
<Arrest_detain_or_charge_with_legal_action>Military_Personnel_(Romania),<Engage_in_diplomatic_cooperation>South_Africa,	<Austria_Press_Agency>
<Praise_or_endorse>Xi_Jinping,	<Fernando_Henrique_Cardoso>
<Consult>Head_of_Government_(China),<Host_a_visit>Middle_East,<Consult>Head_of_Government_(Gambia),	<Nicos_Anastasiades>
<Provide_aid>Malaysia,	<Guerrilla_(El_Salvador)>
<Make_an_appeal_or_request>Japan,	<John_Kerry>
<Reject>Citizen_(India),	<Chief_Court_Judge_(Zambia)>
<Criticize_or_denounce>As'ad_Mustafa,<Accuse>As'ad_Mustafa,	<Lawyer/Attorney_(Colombia)>
<Make_a_visit>Iran,	<Government_(France)>
<Make_a_visit>Kuwait,	<Member_of_Parliament_(Ukraine)>
<Criticize_or_denounce>Citizen_(Nigeria),	<Government_(Nigeria)>
<Consult>Benjamin_Netanyahu,<Praise_or_endorse>Iran,	<Head_of_Government_(India)>
<Consult>Sergey_Kuzhugetovich_Shoygu,<Express_intent_to_cooperate>Cabinet_/_Council_of_Ministers_/_Advisors_(United_States),<Meet_at_a_'third'_location>John_Kerry,<Engage_in_negotiation>Heraldo_Muñoz,<Discuss_by_telephone>Fumio_Kishida,<Discuss_by_telephone>Cabinet_/_Council_of_Ministers_/_Advisors_(United_States),<Engage_in_negotiation>John_Kerry,<Sign_formal_agreement>Angola,<Host_a_visit>John_Kerry,<Express_intent_to_meet_or_negotiate>France,<Express_intent_to_meet_or_negotiate>Catherine_Ashton,<Consult>Rashid_Gumarovich_Nurgaliyev,<Make_an_appeal_or_request>Citizen_(International),<Discuss_by_telephone>Envoy_(United_States),	<ITAR_TASS>
<Consult>Fumio_Kishida,	<Member_of_Parliament_(Bangladesh)>
<Consult>Xi_Jinping,<Consult>Sebastian_Kurz,<Make_a_visit>Head_of_Government_(China),	<Pope_Francis>
<Arrest_detain_or_charge_with_legal_action>Pervez_Musharraf,	<Criminal_(Australia)>
<Express_intent_to_engage_in_diplomatic_cooperation_(such_as_policy_support)>Iran,	<Party_Member_(Turkey)>
<Express_intent_to_cooperate>Reform_Party_(Estonia),	<Employee_(Kuwait)>
<Arrest_detain_or_charge_with_legal_action>Men_(South_Africa),<Reduce_or_break_diplomatic_relations>Foreign_Affairs_(Rwanda),<Reduce_relations>Foreign_Affairs_(Rwanda),<Accuse>Foreign_Affairs_(Rwanda),<Engage_in_diplomatic_cooperation>Angola,	<China>
<Accuse>North_Korea,<Express_intent_to_provide_humanitarian_aid>North_Korea,<Criticize_or_denounce>Lawmaker_(Japan),<Express_intent_to_meet_or_negotiate>North_Korea,<Meet_at_a_'third'_location>Japan,<Engage_in_diplomatic_cooperation>Japan,<Host_a_visit>Akitaka_Saiki,<Make_an_appeal_or_request>Citizen_(South_Korea),	<North_Korea>
<Praise_or_endorse>African_Union,<Host_a_visit>Office_of_the_United_Nations_High_Commissioner_for_Human_Rights,<Praise_or_endorse>François_Bozizé,<Accuse>Government_(Sudan),	<Riek_Machar>
<Arrest_detain_or_charge_with_legal_action>Pervez_Musharraf,<Arrest_detain_or_charge_with_legal_action>Head_of_Government_(Pakistan),<Make_an_appeal_or_request>Pervez_Musharraf,	<Pervez_Musharraf>
<Use_conventional_military_force>Malaysia,	<China>
<Criticize_or_denounce>Member_of_the_Judiciary_(Slovakia),	<Argentine_Naval_Prefecture>
<Consult>Business_(Bahrain),	<Cabinet_/_Council_of_Ministers_/_Advisors_(Thailand)>
<Protest_violently_riot>Foreign_Affairs_(United_States),	<Election_Commission_(India)>
<Provide_aid>Iraq,	<Businessperson_(Turkey)>
<Criticize_or_denounce>Government_(Sudan),	<United_States_Senate>
<Express_intent_to_meet_or_negotiate>Citizen_(Thailand),	<Medical_Personnel_(Switzerland)>
<Obstruct_passage_block>Ruling_Party_(Taiwan),	<Morocco>
<Expel_or_deport_individuals>Citizen_(Sudan),<Appeal_for_de-escalation_of_military_engagement>South_Sudan,<Express_intent_to_engage_in_diplomatic_cooperation_(such_as_policy_support)>Ethiopia,	<Benazir_Bhutto>
<Express_intent_to_meet_or_negotiate>Sauli_Niinistö,	<Julie_Bishop>
<Make_a_visit>United_Arab_Emirates,	<Japan>
<Engage_in_negotiation>Government_(Pakistan),<Express_intent_to_meet_or_negotiate>Government_(Pakistan),	<Australia_Greens>
<Use_unconventional_violence>Citizen_(Yemen),	<Government_(Bahamas)>
<Return_release_person(s)>Reserve_Personnel_(Iran),	<Riek_Machar>
<Host_a_visit>Sushil_Koirala,<Host_a_visit>Naval_(United_States),<Express_intent_to_meet_or_negotiate>Vietnam,<Arrest_detain_or_charge_with_legal_action>Citizen_(Thailand),<Impose_administrative_sanctions>Citizen_(Thailand),	<Cambodia>
<Host_a_visit>John_Kerry,	<Immigrants_(Ethiopia)>
<Kill_by_physical_assault>Citizen_(India),	<Cristina_Fernández_de_Kirchner>
<Consult>Guenther_Oettinger,	<Lawyer/Attorney_(Argentina)>
<Demand_diplomatic_cooperation_(such_as_policy_support)>Government_(South_Africa),	<Media_Personnel_(United_States)>
<Make_a_visit>Philippines,	<Other_Authorities_/_Officials_(Switzerland)>
<Praise_or_endorse>Jens_Stoltenberg,<Make_a_visit>Japan,	<Armed_Gang_(Lebanon)>
<Use_conventional_military_force>Citizen_(United_Arab_Emirates),	<Industrial_/_Textiles_/_Mining_Ministry_(Azerbaijan)>
<Consult>Head_of_Government_(Greece),	<Other_Authorities_/_Officials_(Greece)>
<Investigate>Business_(Norway),	<Cabinet_/_Council_of_Ministers_/_Advisors_(Kazakhstan)>
<Criticize_or_denounce>Ma_Ying_Jeou,<Consult>Civic_Group_(Taiwan),	<Islamic_(India)>
<Consult>Martin_Indyk,	<Treasury/Finance_Ministry_(Czech_Republic)>
<Investigate>Iran,<Make_an_appeal_or_request>Other_Authorities_/_Officials_(Somalia),<Consult>Barack_Obama,<Criticize_or_denounce>Boko_Haram,	<Sudan>
<Express_intent_to_cooperate>Police_(Kenya),<Express_intent_to_cooperate>Indigenous_People_(Kenya),	<William_Ruto>
<Host_a_visit>Foreign_Affairs_(Kuwait),<Make_a_visit>South_Sudan,<Consult>Isaias_Afewerki,	<Sudan>
<Express_intent_to_meet_or_negotiate>Women_(South_Sudan),	<New_Zealand>
<Engage_in_diplomatic_cooperation>Iran,<Criticize_or_denounce>Qatar,<Reduce_or_break_diplomatic_relations>Qatar,<Arrest_detain_or_charge_with_legal_action>Women_(United_Arab_Emirates),	<Raúl_Castro>
<Appeal_for_change_in_leadership>Faith_Pansy_Tlakula,	<New_Zealand>
<Express_intent_to_meet_or_negotiate>France,	<Police_(Jamaica)>
<Host_a_visit>Iurie_Leanca,	<Romania>
<Express_intent_to_engage_in_diplomatic_cooperation_(such_as_policy_support)>Malaysia,<Host_a_visit>Gina_McCarthy,	<Police_(Indonesia)>
<Make_an_appeal_or_request>Citizen_(Hungary),	<Student_(South_Korea)>
<Accuse>Citizen_(Namibia),	<Foreign_Affairs_(United_States)>
<Criticize_or_denounce>Lawmaker_(Crimea),	<Yulia_Tymoshenko>
<Consult>Dmitry_Olegovich_Rogozin,	<Emilio_Pérez_Touriño>
<Consult>Teshome_Togo,<Praise_or_endorse>Xi_Jinping,	<Cambodia>
<Praise_or_endorse>Police_(Kenya),<Appeal_for_diplomatic_cooperation_(such_as_policy_support)>Citizen_(Kenya),	<Government_(Kenya)>
<Return_release_property>Government_(Nigeria),	<China>
<Use_unconventional_violence>Police_(Rwanda),	<Media_(Africa)>
<Demonstrate_or_rally>Foreign_Affairs_(United_States),	<Businessperson_(China)>
<Express_intent_to_cooperate>Head_of_Government_(South_Korea),<Consult>Sergey_Viktorovich_Lavrov,<Consult>Barack_Obama,<Meet_at_a_'third'_location>Barack_Obama,<Express_intent_to_meet_or_negotiate>France,<Make_optimistic_comment>European_Parliament,<Express_intent_to_meet_or_negotiate>Barack_Obama,<Consult>François_Hollande,	<China>
<Make_a_visit>Japan,	<Justin_Trudeau>
<Make_an_appeal_or_request>Elmar_Brok,	<Armed_Gang_(Lebanon)>
<Consult>Raheel_Sharif,	<Head_of_Government_(Latvia)>
<Make_a_visit>Malaysia,	<Amit_Shah>
