sentences	sensitiveAttr
<Make_a_visit>Sudan,	<Chimed_Saikhanbileg>
<Consult>Cabinet_/_Council_of_Ministers_/_Advisors_(United_States),	<Media_(Africa)>
<Host_a_visit>Head_of_Government_(Chad),	<Independence_Party>
<Host_a_visit>Labor_Party_(Norway),	<Military_(Vietnam)>
<Consult>Pierre_Nkurunziza,	<Cabinet_/_Council_of_Ministers_/_Advisors_(Somalia)>
<Consult>Barack_Obama,	<John_Kerry>
<Make_empathetic_comment>Citizen_(Yemen),<Use_conventional_military_force>Citizen_(Yemen),	<Government_(Sweden)>
<Make_an_appeal_or_request>Akhilesh_Yadav,	<Education_(Nigeria)>
<Threaten_with_military_force>Citizen_(Germany),	<Nestor_Kirchner>
<Ease_administrative_sanctions>Media_Personnel_(United_States),<Make_a_visit>China,<Host_a_visit>Ashraf_Ghani_Ahmadzai,<Arrest_detain_or_charge_with_legal_action>Indigenous_People_(Pakistan),<Consult>Ashraf_Ghani_Ahmadzai,<Host_a_visit>Indigenous_People_(India),	<Armed_Band_(Afghanistan)>
<Praise_or_endorse>Angola,	<Lawyer/Attorney_(Colombia)>
<Engage_in_diplomatic_cooperation>Other_Authorities_/_Officials_(China),	<Hamas>
<Use_conventional_military_force>Militant_(Iraq),<Use_conventional_military_force>Iraq,	<Freedom_Fighter_(Zambia)>
<Express_intent_to_meet_or_negotiate>Citizen_(United_Kingdom),	<Canada>
<Criticize_or_denounce>Citizen_(Lithuania),	<Social_Democratic_Party_(Lithuania)>
<Make_an_appeal_or_request>Nigerian_Navy,	<Government_(Nigeria)>
<Demand_change_in_leadership>Police_(Kenya),	<Head_of_Government_(Latvia)>
<Accuse>Bhupinder_Singh_Hooda,	<Criminal_(Argentina)>
<Accuse>Other_Authorities_/_Officials_(Russia),	<Scientist_(Tajikistan)>
<Express_intent_to_meet_or_negotiate>Citizen_(India),	<Combatant_(Islamic_State_of_Iraq_and_the_Levant)>
<Consult>John_Kerry,<Make_pessimistic_comment>North_Atlantic_Treaty_Organization,	<Madeleine_Albright>
<Engage_in_negotiation>Mexico,	<Congo>
<Praise_or_endorse>Hellenic_Armed_Forces,	<Coalition_of_the_Radical_Left>
<fight_with_small_arms_and_light_weapons>Military_(Philippines),	<RIA_Novosti>
<Use_unconventional_violence>South_Africa,	<Head_of_Government_(Germany)>
<Use_unconventional_violence>Military_(Lebanon),	<Raúl_Castro>
<fight_with_small_arms_and_light_weapons>Media_Personnel_(Somalia),	<Mustafa_Dzhemilev>
<Use_unconventional_violence>Citizen_(Nigeria),	<Armed_Band_(Lebanon)>
<Use_unconventional_violence>Hezbollah,	<United_Progressive_Alliance>
<Express_intent_to_engage_in_diplomatic_cooperation_(such_as_policy_support)>Iran,	<Cobra_Matata>
<Praise_or_endorse>Head_of_Government_(Pakistan),<Express_intent_to_meet_or_negotiate>Xi_Jinping,<Express_intent_to_meet_or_negotiate>Citizen_(Saudi_Arabia),<Praise_or_endorse>Iran,<Engage_in_negotiation>Xi_Jinping,<Make_pessimistic_comment>Afghanistan,	<Afghanistan>
<Consult>Police_(Yemen),	<Armed_Gang_(Egypt)>
<Use_unconventional_violence>Police_(Yemen),	<Al_Jazeera>
<Praise_or_endorse>Military_(Lebanon),	<Ivan_Gasparovic>
<Express_intent_to_cooperate>Thailand,	<Republican_People's_Party>
<Praise_or_endorse>Citizen_(Nigeria),	<Media_(Nigeria)>
<Engage_in_negotiation>Other_Authorities_/_Officials_(China),	<Government_(Nepal)>
<Engage_in_negotiation>Iran,<Praise_or_endorse>Colombia,<Make_a_visit>China,	<North_Atlantic_Treaty_Organization>
<Make_optimistic_comment>Iran,	<Iran>
<Praise_or_endorse>Police_(Israel),	<John_Kerry>
<Sign_formal_agreement>Hassan_Tukur,	<Government_(Nigeria)>
<Consult>Angola,	<Air_Force_(Iraq)>
<Consult>Military_Personnel_(Liberia),	<National_Council_for_Peace_and_Order_of_Thailand>
<Consult>Anandiben_Patel,	<Government_(United_States)>
<Praise_or_endorse>Joe_Oliver,<Express_intent_to_meet_or_negotiate>Canada,	<Head_of_Government_(Bulgaria)>
<Express_intent_to_cooperate>Labor_Union_(Uruguay),	<Luis_Alberto_Lacalle>
<Use_conventional_military_force>Student_(Kenya),<Consult>Cyprian_Awiti,	<Court_Judge_(Mexico)>
<Consult>Dmitry_Anatolyevich_Medvedev,	<New_Democracy>
<Express_intent_to_cooperate>Sergey_Viktorovich_Lavrov,<Consult>Ashraf_Ghani_Ahmadzai,	<Fumio_Kishida>
<Make_an_appeal_or_request>Citizen_(Yemen),<Make_an_appeal_or_request>Political_Parties_(Yemen),	<Detainee_(Lebanon)>
<Engage_in_symbolic_act>Canadian_Armed_Forces,<Host_a_visit>Sauli_Niinistö,	<Liberal_Party_(Canada)>
<Increase_military_alert_status>Canada,	<Police_(Middle_East)>
<Sign_formal_agreement>John_Kerry,<Express_intent_to_meet_or_negotiate>John_Kerry,	<Iran>
<Express_intent_to_settle_dispute>Afghanistan,<Express_intent_to_provide_material_aid>Afghanistan,<Express_intent_to_cooperate>Vietnam,<Express_intent_to_provide_economic_aid>Afghanistan,<Engage_in_negotiation>Laos,<Host_a_visit>Yasuo_Fukuda,<Engage_in_diplomatic_cooperation>Afghanistan,<Express_intent_to_cooperate>France,<Engage_in_diplomatic_cooperation>Vietnam,<Consult>Japan,	<Afghanistan>
<Consult>Sergey_Viktorovich_Lavrov,	<Iran>
<Carry_out_suicide_bombing>Iraq,	<Military_(China)>
<Make_optimistic_comment>People_Associated_with_the_Opposition_(Brazil),	<Dalbir_Singh>
<Demand>Viktor_Orban,<Make_an_appeal_or_request>Viktor_Orban,	<Rupiah_Banda>
<Express_intent_to_cooperate>Member_of_Parliament_(India),<Make_an_appeal_or_request>Military_Personnel_(India),<Criticize_or_denounce>Medical_Association_(India),<Conduct_suicide_car_or_other_non-military_bombing>Company_-_Owner_or_Operator_(India),<Use_unconventional_violence>Court_Judge_(India),<Accuse>Medical_Personnel_(India),<fight_with_small_arms_and_light_weapons>Head_of_Government_(India),	<Education_(Nigeria)>
<Criticize_or_denounce>City_Mayor_(Indonesia),	<Imad_Mugniyah>
<Make_an_appeal_or_request>Head_of_Government_(Kenya),<Make_an_appeal_or_request>Government_(Kenya),<Appeal_for_intelligence>Employee_(Kenya),<Make_an_appeal_or_request>Police_(Kenya),<Demand>Jackson_Mandago,	<Volvo>
<Make_an_appeal_or_request>Kit_Siang,	<Foreign_Affairs_(Chile)>
<Use_unconventional_violence>Military_(Mali),	<Foreign_Affairs_(United_States)>
<Demand_diplomatic_cooperation_(such_as_policy_support)>Government_(Nigeria),<Criticize_or_denounce>Niger_Delta_Development_Commission,<Accuse>Muhammadu_Buhari,<Make_an_appeal_or_request>Assemblies_(Nigeria),<Make_an_appeal_or_request>Human_Rights_Commission_(Nigeria),<Make_an_appeal_or_request>Oversight_Court_(Nigeria),<Appeal_for_economic_aid>Government_(Nigeria),	<Employee_(Kuwait)>
<Express_intent_to_meet_or_negotiate>Iraq,	<Lawmaker_(Turkey)>
<Use_unconventional_violence>Police_(South_Korea),	<Arnaud_Montebourg>
<Demonstrate_or_rally>Jakaya_Mrisho_Kikwete,	<Other_Authorities_/_Officials_(Egypt)>
<Use_unconventional_violence>Monastery_(Thailand),	<Martin_McGuinness>
<Protest_violently_riot>Military_(Turkey),	<Government_(France)>
<Use_unconventional_violence>Iraq,	<Member_of_Parliament_(Ukraine)>
<Make_an_appeal_or_request>Military_Police_(Yemen),<Make_an_appeal_or_request>Political_Parties_(Yemen),	<Volvo>
<Praise_or_endorse>National_Police_Service,	<Criminal_(Argentina)>
<Use_unconventional_violence>Cameroon,	<Oluṣẹgun_Ọbasanjọ>
<Make_a_visit>Iraq,	<Member_of_the_Judiciary_(Sierra_Leone)>
<Mobilize_or_increase_armed_forces>Iraq,	<Uhuru_Muigai_Kenyatta>
<Kill_by_physical_assault>Citizen_(United_Kingdom),	<Government_(Germany)>
<Use_unconventional_violence>Armed_Rebel_(Yemen),	<Thief_(India)>
<Express_intent_to_meet_or_negotiate>Citizen_(India),	<Mark_Lyall_Grant>
<Praise_or_endorse>Lawyer/Attorney_(Argentina),<Consult>Presidential_Candidate_(Argentina),	<Guy_Scott>
<Make_pessimistic_comment>Government_(Nigeria),<Make_an_appeal_or_request>Scholar_(Nigeria),	<Morteza_Sarmadi>
<Praise_or_endorse>Evo_Morales,	<Tonga>
<Arrest_detain_or_charge_with_legal_action>Opposition_Activist_(Bahrain),	<Industrial_/_Textiles_/_Mining_Ministry_(Azerbaijan)>
<Impose_administrative_sanctions>Citizen_(India),<Consult>Justice_Department/Ministery_(India),<Accuse>Medical_Personnel_(India),<Arrest_detain_or_charge_with_legal_action>Indigenous_People_(India),	<Medical_Personnel_(India)>
<Threaten>Nuri_al-Maliki,	<Indigenous_People_(Nigeria)>
<Reject>Citizen_(Namibia),<Arrest_detain_or_charge_with_legal_action>Citizen_(Namibia),	<African_Union>
<Arrest_detain_or_charge_with_legal_action>Boko_Haram,<Investigate>Murtala_Nyako,	<Oversight_Court_(Nigeria)>
<Physically_assault>Shahid_Khan,	<Party_Member_(Iraq)>
<Arrest_detain_or_charge_with_legal_action>Citizen_(India),	<Employee_(Liberia)>
<Make_a_visit>South_Korea,<Engage_in_negotiation>Foreign_Affairs_(South_Korea),<Express_intent_to_meet_or_negotiate>Japan,	<Armed_Gang_(United_States)>
<Make_a_visit>South_Korea,<Make_a_visit>Japan,	<Emilio_Pérez_Touriño>
<Use_conventional_military_force>Iraq,	<Militant_(Iraq)>
<Consult>Bismillah_Khan_Mohammadi,	<North_Korea>
<Threaten>Citizen_(Nigeria),	<Raúl_Castro>
<Make_a_visit>Angola,	<Employee_(Kenya)>
<Praise_or_endorse>Hellenic_Navy,	<New_Democracy>
<Engage_in_negotiation>Mohamed_Hassad,	<Guerrilla_(Revolutionary_Armed_Forces_of_Colombia)>
<Make_a_visit>The_Hague,	<Guerrilla_(Revolutionary_Armed_Forces_of_Colombia)>
<Engage_in_diplomatic_cooperation>Abu_Dhabi_Education_Council,	<Malawi_Electoral_Commission>
<Criticize_or_denounce>Rashtriya_Swayamsevak_Sangh,	<Thief_(India)>
<Express_intent_to_meet_or_negotiate>Cabinet_/_Council_of_Ministers_/_Advisors_(Fiji),	<James_Ongwae>
<Express_intent_to_engage_in_diplomatic_cooperation_(such_as_policy_support)>Government_(Sudan),	<Al-Shabaab>
<Consult>Portugal,	<Head_of_Government_(Bahrain)>
<Make_optimistic_comment>Party_Member_(Bolivia),	<Bolivia>
<Make_an_appeal_or_request>Government_(Nigeria),	<Main_Opposition_(South_Africa)>
<Host_a_visit>Omar_Abdullah,	<Holy_See>
<Accuse>Jeremy_Clarkson,	<Abu_Sayyaf>
<Provide_humanitarian_aid>Doctors_Without_Borders,	<Other_Authorities_/_Officials_(Russia)>
<Make_an_appeal_or_request>Swaziland,	<Sue-Ellen_Kovack>
<Consult>Governor_General_(Antigua_and_Barbuda),	<Haaretz>
<Make_a_visit>France,	<Other_Authorities_/_Officials_(Libya)>
<Express_intent_to_meet_or_negotiate>Indigenous_People_(Portugal),	<Mahinda_Rajapaksa>
<Express_intent_to_engage_in_diplomatic_cooperation_(such_as_policy_support)>UN_Security_Council,	<Armenia>
<Make_an_appeal_or_request>Party_Member_(Japan),	<South_Korea>
<Praise_or_endorse>Manuel_Zelaya,<Sign_formal_agreement>Mohamad_Hanif_Atmar,<Consult>Abdelkader_Messahel,	<Angola>
<Mediate>Armenia,<Praise_or_endorse>Malaysia,<Express_intent_to_engage_in_diplomatic_cooperation_(such_as_policy_support)>Opposition_Force_(Syria),<Express_intent_to_meet_or_negotiate>Kazakhstan,<Host_a_visit>Mohamed_Ould_Abdel_Aziz,	<Boko_Haram>
<Make_a_visit>France,<Engage_in_negotiation>François_Hollande,	<Military_(China)>
<Make_an_appeal_or_request>Citizen_(Nigeria),	<Government_(Nigeria)>
<Arrest_detain_or_charge_with_legal_action>Mambury_Njie,	<City_Mayor_(Italy)>
<Criticize_or_denounce>The_Chronicle,	<Pope_Francis>
<Engage_in_diplomatic_cooperation>Employee_(Kenya),<Refuse_to_yield>Citizen_(Kenya),	<Militia_(Kenya)>
<Engage_in_negotiation>Other_Authorities_/_Officials_(China),	<Member_of_the_Judiciary_(Nigeria)>
<Provide_aid>Citizen_(Nigeria),<Express_intent_to_meet_or_negotiate>Citizen_(Nigeria),<Sign_formal_agreement>Boko_Haram,<Declare_truce_ceasefire>Boko_Haram,<Express_intent_to_cooperate>Boko_Haram,<Praise_or_endorse>Education_(Nigeria),	<Medical_Personnel_(Nigeria)>
<Consult>Military_(China),	<Foreign_Affairs_(Syria)>
<Grant_diplomatic_recognition>Iran,	<Riek_Machar>
<Use_conventional_military_force>Armed_Rebel_(Syria),<Reject_request_for_military_aid>Militant_(Syria),	<Armed_Rebel_(Syria)>
<Make_an_appeal_or_request>Head_of_Government_(India),	<Education_Ministry_(France)>
<Express_intent_to_cooperate>Employee_(Kenya),	<James_Ongwae>
<Express_intent_to_meet_or_negotiate>Xi_Jinping,	<Defense_/_Security_Ministry_(India)>
<Make_an_appeal_or_request>Other_Authorities_/_Officials_(Guatemala),	<Bala_Abdulkadir_Mohammed>
<Consult>Iran,<Make_an_appeal_or_request>Legislature_(Iraq),<Consult>Philip_Hammond,	<Iraq>
<fight_with_artillery_and_tanks>Israeli_Defense_Forces,	<Israeli_Defense_Forces>
<Express_intent_to_meet_or_negotiate>China,<Make_a_visit>China,	<Movement_for_Democratic_Change>
<Express_intent_to_meet_or_negotiate>China,	<Japan>
<Praise_or_endorse>Foreign_Affairs_(Norway),	<Riek_Machar>
<Express_intent_to_meet_or_negotiate>Citizen_(Kenya),	<Governor_(Kenya)>
<Make_optimistic_comment>Jens_Stoltenberg,	<Valdis_Dombrovskis>
<Appeal_for_diplomatic_cooperation_(such_as_policy_support)>Citizen_(Nigeria),	<Ministry_(Nigeria)>
<Engage_in_negotiation>Government_Official_(United_States),<Consult>Arseniy_Yatsenyuk,<Consult>Angela_Merkel,	<Verkhovna_Rada>
<Express_intent_to_meet_or_negotiate>Citizen_(Bangladesh),	<Military_(Lebanon)>
<Praise_or_endorse>Tanzania,	<Iran>
<Criticize_or_denounce>Citizen_(Nigeria),	<Nadine_Heredia>
<Criticize_or_denounce>Citizen_(Nigeria),<Appeal_for_intelligence>Other_Authorities_/_Officials_(United_States),	<China>
<Use_unconventional_violence>Citizen_(United_Kingdom),	<African_Union>
<Make_a_visit>France,	<Armenia>
<Host_a_visit>Nguyen_Xuan_Phuc,<Express_intent_to_engage_in_diplomatic_cooperation_(such_as_policy_support)>Iraq,<Make_a_visit>France,<Express_intent_to_provide_economic_aid>Military_(Lebanon),<Express_intent_to_provide_military_aid>Military_(Lebanon),<Engage_in_diplomatic_cooperation>Iraq,<Engage_in_material_cooperation>Iraq,	<Morteza_Sarmadi>
<Criticize_or_denounce>Police_(Turkmenistan),<Host_a_visit>Julie_Bishop,<Employ_aerial_weapons>Militant_(Iraq),<Host_a_visit>Military_Advisor_(United_States),<Investigate>Health_Ministry_(Iraq),	<National_Alliance_(Iraq)>
<Express_intent_to_meet_or_negotiate>China,<Demand>Citizen_(Tanzania),<Make_empathetic_comment>Michael_Sata,<Make_a_visit>China,	<Tanzania>
<Sign_formal_agreement>China,<Express_intent_to_meet_or_negotiate>South_Korea,<Consult>North_Korea,<Express_intent_to_engage_in_diplomatic_cooperation_(such_as_policy_support)>Citizen_(Unidentified_State_Actor),<Host_a_visit>Terry_McAuliffe,<Host_a_visit>Willem-Alexander,<Express_intent_to_cooperate>South_Korea,<Make_an_appeal_or_request>North_Korea,<Reject_plan_agreement_to_settle_dispute>South_Korea,	<China>
<Consult>François_Hollande,	<Foroyaa>
<Make_a_visit>Ibrahim_Boubacar_Keïta,	<France>
<Consult>Mevlut_Cavusoglu,	<North_Atlantic_Treaty_Organization>
<Express_intent_to_meet_or_negotiate>Vietnam,	<Media_Personnel_(Australia)>
<Make_optimistic_comment>Other_Authorities_/_Officials_(Hong_Kong),<Sign_formal_agreement>Sergey_Viktorovich_Lavrov,<Express_intent_to_meet_or_negotiate>John_Baird,<Make_optimistic_comment>North_Korea,<Discuss_by_telephone>Foreign_Affairs_(Russia),<Express_intent_to_meet_or_negotiate>Mohamed_al-Dairi,<Demand_release_of_persons_or_property>North_Korea,	<Iran>
<Accuse>Assemblies_(Nigeria),	<Government_(Nigeria)>
<Make_a_visit>Morocco,<Apologize>Royal_Administration_(Saudi_Arabia),<Express_intent_to_meet_or_negotiate>Citizen_(Turkey),	<Daniel_Ortega>
<Use_unconventional_violence>Citizen_(Bangladesh),	<Military_Personnel_-_Special_(Guinea)>
<Express_intent_to_meet_or_negotiate>Frank_Bainimarama,	<Barack_Obama>
<Consult>Court_Judge_(India),	<Ministry_(Thailand)>
<Make_an_appeal_or_request>Citizen_(Nigeria),	<Haiti>
<Express_intent_to_cooperate>Malaysia,<Host_a_visit>Vesna_Pusić,	<Government_(Nepal)>
<Make_an_appeal_or_request>Victor_Ponta,	<Romania>
<Criticize_or_denounce>Other_Authorities_/_Officials_(Nigeria),	<Guerrilla_(Revolutionary_Armed_Forces_of_Colombia)>
<Engage_in_material_cooperation>Student_(Hong_Kong),	<Villager_(Hong_Kong)>
<Appeal_for_easing_of_administrative_sanctions>The_Hague,<Impose_administrative_sanctions>Student_(Kenya),<Coerce>Men_(Kenya),	<Uhuru>
<Mobilize_or_increase_armed_forces>Iraq,	<Associated_Press>
<Make_a_visit>South_Korea,	<Education_(Nigeria)>
<Praise_or_endorse>Head_of_Government_(Afghanistan),<Make_an_appeal_or_request>Ashraf_Ghani_Ahmadzai,	<Afghanistan>
<Engage_in_diplomatic_cooperation>Colombia,	<Fernando_Henrique_Cardoso>
<Halt_negotiations>Xi_Jinping,<Rally_support_on_behalf_of>Party_Member_(Taiwan),	<China>
<Consult>Undersecretary_(United_States),	<Iran>
<Engage_in_diplomatic_cooperation>Thailand,<Arrest_detain_or_charge_with_legal_action>Police_(Malaysia),	<Armed_Rebel_(Ukraine)>
<Appeal_for_diplomatic_cooperation_(such_as_policy_support)>Citizen_(Namibia),	<Cobra_Matata>
<Praise_or_endorse>Military_(Lebanon),	<Iran>
<Consult>Bishop_(South_Africa),	<Businessperson_(Kenya)>
<Make_an_appeal_or_request>North_Korea,	<Holy_See>
<Express_intent_to_meet_or_negotiate>Iran,	<Militant_(Somalia)>
<Criticize_or_denounce>Member_of_Parliament_(India),	<Business_(Tonga)>
<Reject>Democratic_Party_(Nigeria),	<City_Mayor_(New_Zealand)>
<Reject>Ashraf_Ghani_Ahmadzai,	<François_Hollande>
<Appeal_for_de-escalation_of_military_engagement>Bangladesh_Nationalist_Party,	<Criminal_(El_Salvador)>
<Refuse_to_ease_administrative_sanctions>Education_(Nigeria),<Arrest_detain_or_charge_with_legal_action>Boko_Haram,<Arrest_detain_or_charge_with_legal_action>Criminal_(Boko_Haram),	<Cristina_Fernández_de_Kirchner>
<Abduct_hijack_or_take_hostage>Police_(Philippines),<Conduct_suicide_car_or_other_non-military_bombing>Philippines,	<Industrial_/_Textiles_/_Mining_Ministry_(Azerbaijan)>
<Consult>Government_(Nepal),	<China>
<Grant_diplomatic_recognition>Angola,<Host_a_visit>Salvador_Sánchez_Cerén,	<Indigenous_People_(India)>
<Make_empathetic_comment>Citizen_(Zambia),	<Court_Judge_(Iraq)>
<Occupy_territory>Iraq,	<Military_Personnel_-_Special_(Nigeria)>
<Abduct_hijack_or_take_hostage>Men_(United_Kingdom),<Use_unconventional_violence>Military_(Lebanon),	<Jan_Kohout>
<Use_unconventional_violence>Combatant_(Syrian_Kurds),	<Government_(Ecuador)>
<Use_unconventional_violence>Military_(United_Kingdom),<Use_unconventional_violence>Military_Personnel_-_Special_(Afghanistan),	<Government_Official_(Russia)>
<Abduct_hijack_or_take_hostage>Women_(Ukraine),	<Legislature_(Iraq)>
<Sexually_assault>Women_(Argentina),	<Thailand>
<Reduce_relations>Xu_Caihou,	<Iran>
<Mobilize_or_increase_armed_forces>Angola,	<Defense_/_Security_Ministry_(Malaysia)>
<Accuse>Armed_Band_(Philippines),	<Criminal_(Philippines)>
<Use_conventional_military_force>South_Sudan,	<Imad_Mugniyah>
<Make_an_appeal_or_request>Indigenous_People_(Nigeria),<Consult>Daily_Trust,<Make_an_appeal_or_request>Citizen_(Nigeria),	<Militant_(Boko_Haram)>
<Express_intent_to_meet_or_negotiate>Air_Force_(Taiwan),	<Mwai_Kibaki>
<Use_conventional_military_force>Militant_(Taliban),<Arrest_detain_or_charge_with_legal_action>Military_Personnel_(Afghanistan),	<Media_(Romania)>
<Use_conventional_military_force>Boko_Haram,<Use_conventional_military_force>Citizen_(Nigeria),	<Raj_Thackeray>
<Use_conventional_military_force>Mob_(Sierra_Leone),	<Argentine_Naval_Prefecture>
<Share_intelligence_or_information>Milan_Chovanec,<Express_intent_to_meet_or_negotiate>Citizen_(Czech_Republic),	<Jan_Kohout>
<Host_a_visit>Haider_Al-Abadi,	<Mehr_News_Agency>
<Praise_or_endorse>Other_Authorities_/_Officials_(Nigeria),<Make_an_appeal_or_request>Government_(Nigeria),	<Other_Authorities_/_Officials_(Nigeria)>
<Provide_humanitarian_aid>Iraq,	<Chuck_Hagel>
<Sign_formal_agreement>Foreign_Affairs_(United_States),	<Hezbollah>
<Make_a_visit>France,	<Militia_(Kenya)>
<fight_with_small_arms_and_light_weapons>Children_(Thailand),	<Head_of_Government_(Greece)>
<Express_intent_to_engage_in_diplomatic_cooperation_(such_as_policy_support)>Mauritania,	<Tamerlan_Tsarnaev>
<Make_an_appeal_or_request>Citizen_(Nigeria),	<Air_Force_(Iraq)>
<Express_intent_to_engage_in_diplomatic_cooperation_(such_as_policy_support)>Thailand,<Express_intent_to_cooperate>Thailand,	<Police_(United_States)>
<Praise_or_endorse>Canadian_Armed_Forces,	<Dzhokhar_Tsarnaev>
<Make_an_appeal_or_request>Farm_Worker_(Nigeria),	<State_Security_Service>
<Express_intent_to_meet_or_negotiate>Maldives,	<China>
<Make_a_visit>South_Korea,	<Vietnam>
<Make_a_visit>Iran,	<Government_Official_(Afghanistan)>
<Consult>Antonis_Samaras,	<Police_(Dominican_Republic)>
<Make_empathetic_comment>Okey_Wali,	<Okey_Wali>
<Praise_or_endorse>Poland,	<Military_(Russia)>
<Host_a_visit>Ministry_(Russia),<Engage_in_negotiation>Ryoo_Kihl-jae,<Host_a_visit>Japan,<Provide_aid>Citizen_(North_Korea),<Consult>South_Korea,<Reject>South_Korea,<Arrest_detain_or_charge_with_legal_action>Jeffrey_Fowle,<Return_release_person(s)>Jeffrey_Fowle,<Engage_in_diplomatic_cooperation>Vietnam,	<South_Korea>
<Make_a_visit>Sierra_Leone,	<Government_Official_(Afghanistan)>
<Express_intent_to_meet_or_negotiate>Freedom_Party_(Ukraine),	<Angola>
<Consult>Labor_Union_(India),	<Muhammadu_Buhari>
<Use_unconventional_violence>Government_(Syria),	<United_Arab_Emirates>
<Make_an_appeal_or_request>Umar_al_Bashir,	<Indigenous_People_(India)>
<Reject>Citizen_(Namibia),	<Police_(Rwanda)>
<Criticize_or_denounce>Citizen_(Nigeria),<Sign_formal_agreement>Boko_Haram,	<Government_(Nigeria)>
<Arrest_detain_or_charge_with_legal_action>Men_(Venezuela),	<Social_Democratic_Union>
<Consult>Nguyen_Phu_Trong,	<Government_Official_(Afghanistan)>
<Praise_or_endorse>Farm_Worker_(Burkina_Faso),	<Business_(Bulgaria)>
<Demonstrate_or_rally>Activist_(Sri_Lanka),	<Foreign_Affairs_(United_States)>
<Accuse>Government_(South_Africa),	<Military_Personnel_-_Special_(Afghanistan)>
<Demand>Citizen_(Kenya),	<Associated_Press>
<Reject>Government_(Argentina),	<Party_Member_(Malawi)>
<Express_intent_to_engage_in_diplomatic_cooperation_(such_as_policy_support)>Detainee_(Bahrain),	<Indigenous_People_(United_Kingdom)>
<Praise_or_endorse>Canada,	<Ri_Su_Yong>
<Threaten>North_Atlantic_Treaty_Organization,<Consult>John_Kerry,<Make_empathetic_comment>Michael_Sata,	<Legislature_(Libya)>
<Arrest_detain_or_charge_with_legal_action>Citizen_(South_Korea),	<China>
<Praise_or_endorse>Vietnam,	<Criminal_(Argentina)>
<Consult>Ireland,	<Kazakhstan>
<Make_an_appeal_or_request>Citizen_(Australia),<Accuse>Citizen_(Australia),<Criticize_or_denounce>Citizen_(Australia),<Engage_in_material_cooperation>Other_Authorities_/_Officials_(China),	<Sue-Ellen_Kovack>
<Use_conventional_military_force>Nathan_Cirillo,	<Canadian_Armed_Forces>
<Arrest_detain_or_charge_with_legal_action>Criminal_(Costa_Rica),	<Party_Member_(Iraq)>
<Accuse>Women_(Indonesia),<Arrest_detain_or_charge_with_legal_action>Citizen_(Indonesia),	<New_Zealand>
<Use_conventional_military_force>Armed_Gang_(Palestinian_Territory_Occupied),<Use_conventional_military_force>Children_(Palestinian_Territory_Occupied),	<Republican_People's_Party>
<Investigate>Men_(Japan),	<Medical_Personnel_(Japan)>
<Investigate>Citizen_(Kenya),<Confiscate_property>Citizen_(Kenya),	<Immigrants_(Ethiopia)>
<Arrest_detain_or_charge_with_legal_action>Thief_(Philippines),<Arrest_detain_or_charge_with_legal_action>Employee_(Philippines),	<National_Police>
<Arrest_detain_or_charge_with_legal_action>Student_(Qatar),	<Security_Council_(Russia)>
<fight_with_small_arms_and_light_weapons>Citizen_(South_Korea),	<Student_(South_Korea)>
<Arrest_detain_or_charge_with_legal_action>Criminal_(Sudan),<Arrest_detain_or_charge_with_legal_action>Murderer_(Spain),	<Dmitry_Anatolyevich_Medvedev>
<Seize_or_damage_property>Tanzania,<Use_conventional_military_force>Business_(Tanzania),<Accuse>Criminal_(Tanzania),<fight_with_small_arms_and_light_weapons>Citizen_(Tanzania),	<Immigrants_(Sudan)>
<Return_release_person(s)>Citizen_(Yemen),	<Armed_Rebel_(Yemen)>
<Consult>Legislature_(Jamaica),	<Farm_Worker_(Nigeria)>
<Engage_in_symbolic_act>Men_(Indonesia),	<Member_of_Parliament_(Australia)>
<Demand>Ministry_(Thailand),	<Insurgent_(Thailand)>
<Demonstrate_or_rally>Other_Authorities_/_Officials_(Hong_Kong),<Demonstrate_or_rally>Police_(Hong_Kong),<Consult>Agence_France-Presse,<Consult>Police_(Hong_Kong),	<China>
<Engage_in_diplomatic_cooperation>Iran,	<Abdel_Fattah_Al-Sisi>
<Express_intent_to_meet_or_negotiate>Associated_Press,	<Barack_Obama>
<Make_a_visit>Guinea,	<Nurse_(France)>
<Return_release_person(s)>Citizen_(Germany),	<Kazakhstan>
<Consult>China,	<Military_Personnel_(Thailand)>
<Sign_formal_agreement>Government_(Nigeria),	<Criminal_(Jamaica)>
<Consult>City_Mayor_(Philippines),	<Mauritius>
<Make_pessimistic_comment>Iran,	<Kidnapper_(Mexico)>
<Use_unconventional_violence>Citizen_(India),	<Aam_Aadmi_Party>
<Host_a_visit>Klaus_Johannis,	<Austria_Press_Agency>
<Express_intent_to_meet_or_negotiate>Tom_Motsoahae_Thabane,	<Civic_Group_(Argentina)>
<Consult>Uhuru_Muigai_Kenyatta,	<Military_(Philippines)>
<Make_a_visit>Iraq,	<UN_Security_Council>
<Make_an_appeal_or_request>Citizen_(India),	<Media_Personnel_(Pakistan)>
<Accuse>Abdoulaye_Wade,	<Madeleine_Albright>
<Consult>Foreign_Affairs_(United_States),<Make_an_appeal_or_request>Iran,	<Member_of_Parliament_(Ukraine)>
<Accuse>Citizen_(Nigeria),	<Foreign_Affairs_(United_States)>
<Consult>Defense_/_Security_Ministry_(Russia),	<Malawi_Electoral_Commission>
<Reject>Cristina_Fernández_de_Kirchner,	<Employee_(Philippines)>
<Arrest_detain_or_charge_with_legal_action>Citizen_(South_Korea),	<Legislature_(Libya)>
<Express_intent_to_engage_in_diplomatic_cooperation_(such_as_policy_support)>Armenia,	<International_Monetary_Fund>
<Express_intent_to_meet_or_negotiate>Zakir_Hasanov,	<Military_(Russia)>
<Express_intent_to_meet_or_negotiate>Cabinet_/_Council_of_Ministers_/_Advisors_(United_States),<Express_intent_to_meet_or_negotiate>Foreign_Affairs_(Ukraine),<Consult>Milos_Zeman,<Reject_proposal_to_meet_discuss_or_negotiate>Iran,<Consult>Børge_Brende,<Discuss_by_telephone>John_Kerry,<Consult>Ri_Su_Yong,	<ITAR_TASS>
<Consult>Sultan_Ahmed_bin_Sulayem,	<Member_of_Parliament_(Bangladesh)>
<Use_conventional_military_force>Police_(Peru),	<Pope_Francis>
<Host_a_visit>Sue-Ellen_Kovack,<Host_a_visit>Doctors_Without_Borders,	<Armed_Forces_of_the_Republic_of_Armenia>
<Use_conventional_military_force>Al-Shabaab,<Occupy_territory>Al-Shabaab,	<Nurse_(United_States)>
<Arrest_detain_or_charge_with_legal_action>Citizen_(Nigeria),<Express_intent_to_engage_in_diplomatic_cooperation_(such_as_policy_support)>Japan,	<China>
<Host_a_visit>North_Korea,<Host_a_visit>Xi_Jinping,<fight_with_small_arms_and_light_weapons>North_Korea,<Appeal_to_yield>North_Korea,<Engage_in_negotiation>China,<Make_a_visit>Japan,<Express_intent_to_cooperate>North_Korea,	<North_Korea>
<Host_a_visit>Barnaba_Marial_Benjamin,	<Riek_Machar>
<Consult>North_Korea,	<Klaus_Johannis>
<Consult>Carrie_Lam,<Demonstrate_or_rally>China,	<Police_(Hong_Kong)>
<Demonstrate_or_rally>Terrorist_(Islamic_State_of_Iraq_and_the_Levant),	<Election_Commission_(India)>
<Express_intent_to_cooperate>Police_(Kenya),	<Education_(Greece)>
<Consult>Police_(Hong_Kong),	<Armed_Gang_(Benin)>
<Host_a_visit>High_Commission_for_Refugees,	<Benazir_Bhutto>
<Engage_in_diplomatic_cooperation>International_Federation_of_Red_Cross_and_Red_Crescent_Societies,<Make_a_visit>Sierra_Leone,	<Indigenous_People_(Nigeria)>
<Consult>Media_(Pakistan),	<Government_(Pakistan)>
<Consult>Burundi,<Host_a_visit>International_Monetary_Fund,<Express_intent_to_engage_in_diplomatic_cooperation_(such_as_policy_support)>China,	<Government_(Ecuador)>
<Threaten>Iraq,	<UN_Security_Council>
<Express_intent_to_cooperate>Bahrain,<Cooperate_economically>Cambodia,	<Cambodia>
<Make_a_visit>Cambodia,	<Tamerlan_Tsarnaev>
<Express_intent_to_meet_or_negotiate>International_Monetary_Fund,	<Ministry_(Iran)>
<Host_a_visit>Paul_Kagame,<Host_a_visit>Uhuru,	<Immigrants_(Ethiopia)>
<Praise_or_endorse>Mexico,	<Armed_Gang_(Egypt)>
<Make_an_appeal_or_request>Government_(Africa),	<Member_of_Parliament_(Romania)>
<Express_intent_to_meet_or_negotiate>Canada,	<Nigerian_Bar_Association>
<Praise_or_endorse>Iran,	<Emilio_Pérez_Touriño>
<Arrest_detain_or_charge_with_legal_action>Criminal_(Trinidad_and_Tobago),	<Other_Authorities_/_Officials_(Zimbabwe)>
<Make_an_appeal_or_request>Party_Member_(Taiwan),	<Islamic_(India)>
<Praise_or_endorse>Ministry_(Iraqi_Kurds),<Rally_support_on_behalf_of>Employee_(Ukraine),	<Sudan>
<Accede_to_demands_for_change_in_leadership>William_Ruto,<Express_intent_to_meet_or_negotiate>The_Hague,<Make_a_visit>The_Hague,	<National_Youth_Service>
<Make_an_appeal_or_request>Citizen_(Kenya),	<William_Ruto>
<Consult>Royal_Administration_(Saudi_Arabia),<Consult>Abdel_Fattah_Al-Sisi,	<Sudan>
<Praise_or_endorse>Morocco,	<Raúl_Castro>
<Make_a_visit>Irakli_Alasania,	<National_Alliance_(Iraq)>
<Make_an_appeal_or_request>Milos_Zeman,	<Milos_Zeman>
<Demand_change_in_leadership>Citizen_(Croatia),	<Lawmaker_(Turkey)>
<Host_a_visit>Joe_Natuman,<Host_a_visit>China,<Return_release_person(s)>Dissident_(Vietnam),<Praise_or_endorse>Tanzania,<Express_intent_to_cooperate>China,<Express_intent_to_settle_dispute>China,<Engage_in_diplomatic_cooperation>North_Korea,	<Police_(Indonesia)>
<Provide_aid>Citizen_(India),	<Protester_(Hong_Kong)>
<Accuse>Iran,	<Iran>
<Threaten_non-force>Citizen_(Kenya),	<Government_(Kenya)>
<Make_an_appeal_or_request>Government_(Kenya),	<Kidnapper_(Afghanistan)>
<Engage_in_negotiation>Ma_Ying_Jeou,<Consult>Yasuo_Fukuda,<Appeal_for_diplomatic_cooperation_(such_as_policy_support)>Military_(China),	<China>
<Consult>Victoria_Nuland,	<Armed_Gang_(Lebanon)>
<Engage_in_negotiation>Sergey_Kuzhugetovich_Shoygu,	<Armed_Forces_of_the_Republic_of_Armenia>
<Make_an_appeal_or_request>Other_Authorities_/_Officials_(Venezuela),	<Franklin_Drilon>
