sentences	sensitiveAttr
<Sign_formal_agreement>Business_(Lithuania),	<Armed_Band_(Afghanistan)>
<Express_intent_to_meet_or_negotiate>Chaudhry_Nisar_Ali_Khan,	<Iran>
<Accuse>Ministry_(Afghanistan),<Consult>Party_Member_(Afghanistan),	<John_Kerry>
<Reject_plan_agreement_to_settle_dispute>Devlet_Bahçeli,<Reduce_or_break_diplomatic_relations>China,	<Businessperson_(Turkey)>
<Demand_change_in_leadership>Cabinet_/_Council_of_Ministers_/_Advisors_(Thailand),	<Owen_Ellington>
<Accuse>Iran,	<Liberals_(Canada)>
<Abduct_hijack_or_take_hostage>Businessperson_(China),	<Nestor_Kirchner>
<Praise_or_endorse>China,	<State_Security_Service>
<Praise_or_endorse>Ashraf_Ghani_Ahmadzai,<Express_intent_to_meet_or_negotiate>Iran,	<Armed_Band_(Afghanistan)>
<Make_a_visit>Iran,	<China>
<Express_intent_to_meet_or_negotiate>Head_of_Government_(India),	<Xi_Jinping>
<Acknowledge_or_claim_responsibility>Djibouti,<Use_conventional_military_force>Djibouti,	<Police_(Dominican_Republic)>
<Make_an_appeal_or_request>Antonis_Samaras,	<France>
<Make_optimistic_comment>Citizen_(Lithuania),	<Social_Democratic_Party_(Lithuania)>
<Criticize_or_denounce>Boko_Haram,	<Government_(Nigeria)>
<Express_intent_to_meet_or_negotiate>Canada,	<Julie_Bishop>
<Consult>Head_of_Government_(Ukraine),	<Madeleine_Albright>
<Consult>Cape_Verde,	<Congo>
<Accuse>Main_Opposition_(Greece),	<Coalition_of_the_Radical_Left>
<Criticize_or_denounce>Political_Parties_(Brazil),	<Yemi_Osinbajo>
<Sign_formal_agreement>Government_(Syria),	<Pervez_Musharraf>
<Use_unconventional_violence>Citizen_(Yemen),<Assassinate>Defense_/_Security_Ministry_(Yemen),	<Argentine_Naval_Prefecture>
<Use_unconventional_violence>Muslim_Cleric_(Libya),<Use_unconventional_violence>Police_(Libya),	<Court_Judge_(Iraq)>
<Abduct_hijack_or_take_hostage>Priest_(Uganda),	<The_Standard>
<Use_unconventional_violence>Villager_(Thailand),	<Media_Personnel_(Thailand)>
<Use_unconventional_violence>Military_(Mali),	<Government_(Mauritania)>
<Use_unconventional_violence>Activist_(Syria),<Retreat_or_surrender_militarily>Government_(Syria),<Use_unconventional_violence>Government_(Syria),	<United_Progressive_Alliance>
<Consult>Iran,<Engage_in_diplomatic_cooperation>Iran,<Consult>Tajikistan,<Host_a_visit>François_Hollande,	<Cobra_Matata>
<Use_conventional_military_force>Citizen_(Venezuela),	<Member_of_Parliament_(Romania)>
<Make_an_appeal_or_request>Abdel_Fattah_Al-Sisi,	<South_Africa>
<Sign_formal_agreement>Mauro_Borges,	<Education_Ministry_(France)>
<Make_an_appeal_or_request>Citizen_(International),	<Military_(Russia)>
<Accuse>Government_(Syria),	<Medical_Personnel_(Nigeria)>
<Reject>Member_of_Parliament_(Kuwait),	<Government_(Venezuela)>
<Make_pessimistic_comment>Vietnam,<Express_intent_to_meet_or_negotiate>Japan,	<Head_of_Government_(Ukraine)>
<Conduct_suicide_car_or_other_non-military_bombing>Colombia,	<Naval_(China)>
<Use_unconventional_violence>Citizen_(Xinjiang Uyghur),	<Karim_Wade>
<Accuse>Citizen_(Nigeria),	<Haaretz>
<Accuse>Abu_Bakr_al-Baghdadi,	<Henry_M._Paulson>
<Express_intent_to_cooperate>Citizen_(Nigeria),	<Media_(Nigeria)>
<Decline_comment>Iran,	<Imad_Mugniyah>
<Consult>Angela_Merkel,<Consult>Eric_Ken_Shinseki,<Host_a_visit>Angela_Merkel,<Make_a_visit>Poland,<Express_intent_to_meet_or_negotiate>Poland,<Make_empathetic_comment>Citizen_(Turkey),<Impose_embargo_boycott_or_sanctions>Myanmar,	<North_Atlantic_Treaty_Organization>
<Make_a_visit>Ethiopia,	<Defense_/_Security_Ministry_(South_Sudan)>
<Discuss_by_telephone>Reuven_Rivlin,<Consult>Tzipi_Livni,<Express_intent_to_meet_or_negotiate>Japan,	<John_Kerry>
<fight_with_small_arms_and_light_weapons>Cameroon,<Make_pessimistic_comment>Citizen_(Nigeria),<Consult>Oluṣẹgun_Ọbasanjọ,<Use_unconventional_violence>Citizen_(Nigeria),<Express_intent_to_release_persons_or_property>Citizen_(Nigeria),<Use_conventional_military_force>Military_Personnel_-_Special_(Nigeria),<Accuse>Citizen_(Nigeria),	<Government_(Nigeria)>
<Consult>Sergey_Kuzhugetovich_Shoygu,<Consult>Foreign_Affairs_(Russia),	<Sikh_(India)>
<Make_an_appeal_or_request>Citizen_(Nigeria),	<Israeli_Defense_Forces>
<Express_intent_to_engage_in_diplomatic_cooperation_(such_as_policy_support)>Ingush,	<Student_(Tanzania)>
<Meet_at_a_'third'_location>Niger,	<Aam_Aadmi_Party>
<Arrest_detain_or_charge_with_legal_action>Children_(Canada),<Praise_or_endorse>Government_(Kenya),<Make_an_appeal_or_request>Military_Personnel_(Canada),	<Liberal_Party_(Canada)>
<Arrest_detain_or_charge_with_legal_action>Citizen_(Cape_Verde),	<Lawyer/Attorney_(Uganda)>
<Make_a_visit>South_Korea,	<Iran>
<Consult>Malaysia,<Express_intent_to_meet_or_negotiate>South_Africa,<Host_a_visit>Ministry_(Iran),<Express_intent_to_engage_in_diplomatic_cooperation_(such_as_policy_support)>Portugal,<Use_tactics_of_violent_repression>News_Editor_(China),<Accuse>Philippines,<Accuse>Japan,<Reduce_relations>Japan,<Engage_in_diplomatic_cooperation>Ethiopia,<Coerce>Liu_Han,<Host_a_visit>Head_of_Government_(Turkmenistan),<Criticize_or_denounce>Lawmaker_(United_States),<Arrest_detain_or_charge_with_legal_action>Liu_Han,<Make_optimistic_comment>Iran,<Accuse>Separatist_Militant_(Xinjiang Uyghur),<Consult>Foreign_Affairs_(United_States),<Provide_humanitarian_aid>Vietnam,<Express_intent_to_engage_in_diplomatic_cooperation_(such_as_policy_support)>Ethiopia,<Make_an_appeal_or_request>Afghanistan,<Host_a_visit>Chang_Wanquan,<Engage_in_diplomatic_cooperation>Japan,<Express_intent_to_engage_in_diplomatic_cooperation_(such_as_policy_support)>Malaysia,	<Afghanistan>
<Make_a_visit>Foreign_Affairs_(South_Korea),	<Iran>
<Threaten>Labor_and_Employment_Ministry_(Australia),	<Military_(China)>
<Make_an_appeal_or_request>Member_of_the_Judiciary_(Greece),	<Business_(Canada)>
<Make_optimistic_comment>Governor_(India),<Criticize_or_denounce>New_Way_Movement,<Demonstrate_or_rally>Party_President_(Bharatiya_Janata),<Reject>Tarun_Gogoi,	<Education_(Nigeria)>
<Express_intent_to_engage_in_diplomatic_cooperation_(such_as_policy_support)>Prabowo_Subianto,	<Imad_Mugniyah>
<Reject>Government_(Kenya),	<Volvo>
<Accede_to_requests_or_demands_for_political_reform>Mauritania,	<Ukrinform>
<Make_an_appeal_or_request>Boko_Haram,<Make_an_appeal_or_request>Ministry_(Nigeria),<Make_an_appeal_or_request>Trade_Union_Congress,<Criticize_or_denounce>Boko_Haram,<Criticize_or_denounce>Alex_Badeh,<Express_intent_to_meet_or_negotiate>Boko_Haram,<Make_pessimistic_comment>Government_(Nigeria),<Engage_in_symbolic_act>Royal_Administration_(Nigeria),	<Employee_(Kuwait)>
<Demand_meeting_negotiation>Head_of_Government_(South_Korea),<Criticize_or_denounce>Japan,	<Arnaud_Montebourg>
<Demand>Citizen_(Nigeria),	<Head_of_Government_(Germany)>
<Accuse>Police_(Tanzania),<Conduct_suicide_car_or_other_non-military_bombing>Tanzania,	<Other_Authorities_/_Officials_(Egypt)>
<Express_intent_to_meet_or_negotiate>Togo,	<Holy_See>
<Accuse>Associated_Press,<Accuse_of_espionage_treason>Other_Authorities_/_Officials_(Venezuela),	<Military_(Lebanon)>
<Make_an_appeal_or_request>Party_Member_(Yemen),<Make_an_appeal_or_request>Employee_(Yemen),	<Volvo>
<Make_an_appeal_or_request>Citizen_(Venezuela),	<Colombia>
<Make_an_appeal_or_request>Joseph_Ole_Lenku,	<Criminal_(Argentina)>
<Appeal_for_easing_of_administrative_sanctions>Morocco,	<Morocco>
<Accuse>Evangelos_Venizelos,<Accuse>Panhellenic_Socialist_Movement,	<New_Democracy>
<Host_a_visit>Human_Rights_Watch,<Arrest_detain_or_charge_with_legal_action>Luis_Alfonso_Hoyos,	<Combatant_(Islamic_State_of_Iraq_and_the_Levant)>
<Make_an_appeal_or_request>Election_Commission_(India),<Accuse>Employee_(India),	<Ethnic_Group_(India)>
<Consult>Foreign_Affairs_(Belarus),	<Air_Force_(Iraq)>
<Complain_officially>Employee_(India),	<Thief_(India)>
<Host_a_visit>Herve_Ladsous,	<Romania>
<Refuse_to_release_persons_or_property>Men_(India),	<Medical_Personnel_(India)>
<Make_an_appeal_or_request>Member_of_the_Judiciary_(Nigeria),	<Oversight_Court_(Nigeria)>
<Arrest_detain_or_charge_with_legal_action>Citizen_(United_Kingdom),	<Government_(Panama)>
<Return_release_person(s)>Citizen_(Brazil),	<Police_(Senegal)>
<Make_a_visit>Mexico,	<Government_(Argentina)>
<Consult>Pogu_Bitrus,	<Government_(Bahamas)>
<Make_optimistic_comment>Secretariat_(Nigeria),	<Ministry_(Nigeria)>
<Consult>Benjamin_Netanyahu,	<North_Korea>
<Express_intent_to_provide_material_aid>Citizen_(Yemen),<Make_an_appeal_or_request>Combatant_(Yemen),	<Military_(Central_African_Republic)>
<Host_a_visit>Preneet_Kaur,	<Aam_Aadmi_Party>
<Consult>Angela_Merkel,<Express_intent_to_meet_or_negotiate>Armenia,<Consult>Sergey_Viktorovich_Lavrov,	<Abdul_Aziz>
<Arrest_detain_or_charge_with_legal_action>Citizen_(Djibouti),	<Legislature_(Turkey)>
<Express_intent_to_meet_or_negotiate>Citizen_(Kyrgyzstan),	<Salvador_Sánchez_Cerén>
<Demand>Gazprom,	<Arseniy_Yatsenyuk>
<Make_an_appeal_or_request>Member_of_the_Judiciary_(United_States),	<Ogbeni_Rauf_Aregbesola>
<Accuse_of_human_rights_abuses>Myanmar,	<South_Sudan>
<Consult>Party_Member_(Afghanistan),	<Party_Member_(Afghanistan)>
<Praise_or_endorse>Citizen_(India),	<Ministry_(Czech_Republic)>
<Use_conventional_military_force>Aam_Aadmi_Party,<Use_conventional_military_force>Dharamvira_Gandhi,	<Thief_(India)>
<Demonstrate_or_rally>China,	<Military_(France)>
<Praise_or_endorse>Iran,	<Madeleine_Albright>
<Praise_or_endorse>Citizen_(Germany),<Make_a_visit>Romania,	<Armed_Gang_(Egypt)>
<Make_an_appeal_or_request>Citizen_(Greece),	<North_Atlantic_Treaty_Organization>
<Host_a_visit>Joseph_Robinette_Biden,	<Police_(Ukraine)>
<Praise_or_endorse>Viktor_Orban,	<Member_of_the_Judiciary_(Nigeria)>
<Consult>Company_-_Owner_or_Operator_(Armenia),	<Jason_C._Hu>
<Praise_or_endorse>Other_Authorities_/_Officials_(Libya),<Make_an_appeal_or_request>Canada,	<Armenia>
<Consult>Envoy_(Vietnam),	<Iran>
<Demand>Malawi_Electoral_Commission,<Make_optimistic_comment>China,<Make_an_appeal_or_request>Sudan,	<Angola>
<Engage_in_diplomatic_cooperation>Other_Authorities_/_Officials_(Mali),<Express_intent_to_engage_in_diplomatic_cooperation_(such_as_policy_support)>Japan,<Sign_formal_agreement>China,<Make_an_appeal_or_request>European_Central_Bank,<Express_intent_to_engage_in_diplomatic_cooperation_(such_as_policy_support)>Vietnam,<Make_an_appeal_or_request>UN_Security_Council,<Engage_in_diplomatic_cooperation>Mauritania,	<Boko_Haram>
<Host_a_visit>Japan,	<Congress_(Philippines)>
<Make_a_visit>France,<Host_a_visit>Angela_Merkel,	<Boko_Haram>
<Consult>Rashid_Derbas,	<Foreign_Affairs_(Russia)>
<Consult>Gideon_Gono,	<Angela_Merkel>
<Arrest_detain_or_charge_with_legal_action>Women_(Sierra_Leone),	<Head_of_Government_(Greece)>
<Engage_in_material_cooperation>Police_(Kenya),	<Militia_(Kenya)>
<Praise_or_endorse>Chevron,<Express_intent_to_engage_in_diplomatic_cooperation_(such_as_policy_support)>Military_Personnel_(Nigeria),<Make_an_appeal_or_request>Company_-_Owner_or_Operator_(Nigeria),<Make_an_appeal_or_request>Citizen_(Nigeria),<Make_an_appeal_or_request>UN_Security_Council,	<Medical_Personnel_(Nigeria)>
<Criticize_or_denounce>Thailand,<Express_intent_to_engage_in_diplomatic_cooperation_(such_as_policy_support)>Indigenous_People_(South_Africa),	<Defense_/_Security_Ministry_(Nigeria)>
<Praise_or_endorse>Ministry_(Angola),<Consult>Angola,	<Angola>
<Consult>Tourist_Board_(Kenya),	<James_Ongwae>
<Criticize_or_denounce>People_Associated_with_the_Opposition_(Russia),	<Company_-_Owner_or_Operator_(India)>
<Host_a_visit>Foreign_Affairs_(United_States),<Engage_in_diplomatic_cooperation>Angola,<Criticize_or_denounce>Citizen_(Guinea),	<Court_Judge_(Mexico)>
<Make_a_visit>Tajikistan,	<Thailand>
<Make_an_appeal_or_request>Political_Parties_(Kosovo),	<Catherine_Ashton>
<Consult>Xi_Jinping,<Appeal_for_diplomatic_cooperation_(such_as_policy_support)>Ethiopia,	<Japan>
<Demand>Protester_(Egypt),	<Boko_Haram>
<Praise_or_endorse>Employee_(India),<Reject>Tarun_Gogoi,	<Company_-_Owner_or_Operator_(India)>
<Reject>Boko_Haram,<Make_an_appeal_or_request>Citizen_(Nigeria),	<Ministry_(Nigeria)>
<Consult>Foreign_Affairs_(United_States),<Host_a_visit>Zhang_Dejiang,	<Armenia>
<Consult>Barack_Obama,	<Arnaud_Montebourg>
<Consult>Media_(Nigeria),	<Ministry_(Nigeria)>
<Praise_or_endorse>Efkan_Ala,	<Air_Force_(Iraq)>
<Impose_embargo_boycott_or_sanctions>Other_Authorities_/_Officials_(Venezuela),	<Criminal_(Australia)>
<Arrest_detain_or_charge_with_legal_action>Citizen_(South_Korea),	<Government_(Sweden)>
<Use_unconventional_violence>Citizen_(India),	<Milos_Zeman>
<Engage_in_negotiation>Amnesty_International,	<Education_(Nigeria)>
<Consult>Head_of_Government_(Gambia),	<Mauritius>
<Return_release_person(s)>Citizen_(Nigeria),	<Media_Personnel_(Pakistan)>
<Provide_humanitarian_aid>Portugal,<Consult>Shkelqim_Cani,	<Colombia>
<Express_intent_to_engage_in_diplomatic_cooperation_(such_as_policy_support)>Slovenia,<Engage_in_diplomatic_cooperation>Kuwait,<Sign_formal_agreement>United_Arab_Emirates,<Meet_at_a_'third'_location>Catherine_Ashton,<Arrest_detain_or_charge_with_legal_action>Hunter_(Spain),<Engage_in_negotiation>UN_Security_Council,<Sign_formal_agreement>Iraq,<Praise_or_endorse>Company_-_Owner_or_Operator_(Iran),<Host_a_visit>Poland,<Consult>Islamic_Preacher_(Iran),	<Morteza_Sarmadi>
<Arrest_detain_or_charge_with_legal_action>Militant_(Iraq),	<National_Alliance_(Iraq)>
<Make_a_visit>Sudan,<Consult>Umar_al_Bashir,	<Media_(Romania)>
<Arrest_detain_or_charge_with_legal_action>Children_(Israel),	<Iran>
<Express_intent_to_engage_in_diplomatic_cooperation_(such_as_policy_support)>Angela_Merkel,	<Găgăuzia>
<Accuse>Riek_Machar,	<Guerrilla_(El_Salvador)>
<Express_intent_to_engage_in_diplomatic_cooperation_(such_as_policy_support)>Vietnam,	<Maldives>
<Consult>Domestic_Affairs_(Yemen),	<Ministry_(Nigeria)>
<Impose_embargo_boycott_or_sanctions>North_Korea,<Make_a_visit>China,<Make_a_visit>Franklin_Drilon,<Host_a_visit>Caroline_Kennedy,<Express_intent_to_engage_in_diplomatic_cooperation_(such_as_policy_support)>Malaysia,	<China>
<Appeal_for_diplomatic_cooperation_(such_as_policy_support)>Citizen_(Thailand),<Consult>Military_Personnel_(Thailand),	<Education_(Angola)>
<Express_intent_to_meet_or_negotiate>France,	<France>
<Express_intent_to_meet_or_negotiate>Riek_Machar,<Make_pessimistic_comment>North_Korea,<Make_pessimistic_comment>Ethiopia,<Consult>Joseph_Kabila,<Make_a_visit>Angola,<Make_a_visit>South_Korea,<Demand>Government_(Palestinian_Territory_Occupied),<Consult>Foreign_Affairs_(Singapore),<Express_intent_to_meet_or_negotiate>Mexico,<Appeal_for_diplomatic_cooperation_(such_as_policy_support)>Ethiopia,	<Iran>
<Consult>Raheel_Sharif,	<William_Ruto>
<Appeal_for_diplomatic_cooperation_(such_as_policy_support)>Guinea,	<Business_(Bahrain)>
<Make_a_visit>France,	<Héctor_Beltrán_Leyva>
<Praise_or_endorse>Population_(Iraq),<Consult>Victor_Ponta,<Make_a_visit>Fang_Fenghui,<Make_a_visit>Romania,	<Daniel_Ortega>
<Accuse>Military_(United_Kingdom),	<Chimed_Saikhanbileg>
<Use_conventional_military_force>Tim_Hudak,<Make_a_visit>Canada,<Criticize_or_denounce>Tim_Hudak,	<Police_(Bulgaria)>
<Host_a_visit>Ali_Tayyebnia,	<Government_(Nepal)>
<Make_an_appeal_or_request>Citizen_(North_Korea),	<North_Korea>
<Consult>Council_of_Europe,	<Defense_/_Security_Ministry_(Ukraine)>
<Make_an_appeal_or_request>North_Atlantic_Treaty_Organization,	<Verkhovna_Rada>
<Investigate>Iran,	<Criminal_(Argentina)>
<Criticize_or_denounce>Police_(Australia),	<Police_(Australia)>
<Investigate>Citizen_(Venezuela),	<Criminal_(Australia)>
<Criticize_or_denounce>Joaquim_Barbosa,	<Villager_(Philippines)>
<Arrest_detain_or_charge_with_legal_action>Citizen_(Malaysia),	<Ogbeni_Rauf_Aregbesola>
<Make_an_appeal_or_request>Police_(South_Korea),<Arrest_detain_or_charge_with_legal_action>Citizen_(South_Korea),	<Business_(South_Korea)>
<Engage_in_symbolic_act>Laos,	<Criminal_(Israel)>
<Praise_or_endorse>City_Mayor_(Greece),	<Mohamed_Ould_Abdel_Aziz>
<Demand>Vietnam,	<China>
<Appeal_for_intelligence>Election_Commission_(India),	<François_Hollande>
<Engage_in_diplomatic_cooperation>Iran,	<Armed_Rebel_(Ukraine)>
<Make_a_visit>France,	<Iraq>
<Engage_in_diplomatic_cooperation>France,	<Criminal_(Jamaica)>
<Consult>Pinarayi_Vijayan,	<Fidesz>
<Discuss_by_telephone>Party_Member_(Latvia),	<Moro_National_Liberation_Front>
<Engage_in_negotiation>Julia_Gillard,	<Criminal_(Australia)>
<Sexually_assault>Employee_(India),	<Head_of_Government_(India)>
<Make_an_appeal_or_request>Kazakhstan,	<Court_Judge_(Mexico)>
<Investigate>Lawyer/Attorney_(Turkey),	<Criminal_(Pakistan)>
<Physically_assault>Citizen_(Australia),	<South_Sudan>
<Acknowledge_or_claim_responsibility>South_Africa,<Appeal_for_diplomatic_cooperation_(such_as_policy_support)>Indigenous_People_(South_Africa),	<Businessperson_(Turkey)>
<Praise_or_endorse>Laos,	<China>
<Make_a_visit>Defense_/_Security_Ministry_(United_States),	<United_Arab_Emirates>
<Abduct_hijack_or_take_hostage>Citizen_(Nigeria),	<Police_(Jamaica)>
<Carry_out_suicide_bombing>Iraq,<Abduct_hijack_or_take_hostage>Hezbollah,	<Military_Personnel_-_Special_(Nigeria)>
<fight_with_small_arms_and_light_weapons>Military_(Mali),	<Student_(South_Korea)>
<Use_unconventional_violence>Citizen_(Nigeria),	<Nadine_Heredia>
<Appeal_for_diplomatic_cooperation_(such_as_policy_support)>Citizen_(Yemen),	<Police_(Australia)>
<Use_conventional_military_force>Citizen_(Mali),	<Military_(Central_African_Republic)>
<Use_conventional_military_force>Armed_Rebel_(Mali),<Use_conventional_military_force>Combatant_(Mali),	<Employee_(Canada)>
<Use_conventional_military_force>Drug_Gang_(Mexico),<Arrest_detain_or_charge_with_legal_action>Mexico,	<Insurgent_(Thailand)>
<Use_conventional_military_force>Armed_Gang_(RENAMO),<Confiscate_property>Business_(Mozambique),	<Armed_Rebel_(Yemen)>
<Praise_or_endorse>Riek_Machar,	<Imad_Mugniyah>
<Impose_state_of_emergency_or_martial_law>Thailand,<Use_unconventional_violence>Citizen_(Thailand),<Confiscate_property>Thailand,<Investigate>Citizen_(Thailand),<Arrest_detain_or_charge_with_legal_action>Citizen_(Thailand),<Investigate>Thailand,<Return_release_person(s)>Citizen_(Thailand),	<Head_of_Government_(Latvia)>
<Praise_or_endorse>Military_Personnel_-_Special_(Afghanistan),	<Martin_Spegelj>
<Consult>Sheikh_Hamad_bin_Isa_al_Khalifah,	<Joaquim_Barbosa>
<Use_conventional_military_force>Philippines,	<Philippines>
<Demand_diplomatic_cooperation_(such_as_policy_support)>Government_Official_(Thailand),	<Thailand>
<Appeal_for_diplomatic_cooperation_(such_as_policy_support)>South_Korea,	<Domestic_Affairs_(Kenya)>
<Use_conventional_military_force>Garo_National_Liberation_Army,	<Sergey_Viktorovich_Lavrov>
<Use_conventional_military_force>Terrorist_Leader_(Boko_Haram),	<Raj_Thackeray>
<Praise_or_endorse>Citizen_(India),	<Al_Jazeera>
<Consult>Paul_Kagame,	<Angola>
<Consult>Aristide_Sokambi,	<Government_(France)>
<Demand>Citizen_(Guyana),	<Education_Ministry_(France)>
<Express_intent_to_meet_or_negotiate>Abu_Bakr_Abdullah_al-Qirbi,	<Mehr_News_Agency>
<Express_intent_to_cooperate>Company_-_Owner_or_Operator_(Nigeria),	<Other_Authorities_/_Officials_(Nigeria)>
<Make_an_appeal_or_request>Citizen_(Sudan),	<Government_(Sudan)>
<Use_conventional_military_force>Citizen_(Tanzania),	<Barack_Obama>
<Halt_negotiations>Catherine_Ashton,	<Iran>
<Arrest_detain_or_charge_with_legal_action>Men_(Morocco),<Arrest_detain_or_charge_with_legal_action>Criminal_(Morocco),	<Tamerlan_Tsarnaev>
<Praise_or_endorse>Barack_Obama,	<Armed_Gang_(United_States)>
<Consult>Datuk_Seri_Tengku_Adnan_Tengku_Mansor,	<Ahmed_Abu_Khatallah>
<Arrest_detain_or_charge_with_legal_action>Media_Personnel_(Thailand),	<Business_(Bahrain)>
<Demand>Education_(Azerbaijan),	<National_Liberal_Party>
<Express_intent_to_cooperate>Citizen_(Nigeria),	<Middle_East>
<Express_intent_to_engage_in_diplomatic_cooperation_(such_as_policy_support)>Japan,	<Military_(Russia)>
<Engage_in_diplomatic_cooperation>China,	<South_Korea>
<Consult>Hamas,	<Madeleine_Albright>
<Make_optimistic_comment>Citizen_(Nigeria),	<Sule_Lamido>
<Make_a_visit>Iran,	<Poland>
<Make_an_appeal_or_request>Citizen_(Saudi_Arabia),	<Burundi>
<Express_intent_to_engage_in_diplomatic_cooperation_(such_as_policy_support)>Portugal,	<Middle_East>
<Arrest_detain_or_charge_with_legal_action>Criminal_(El_Salvador),	<Tanzania>
<Provide_humanitarian_aid>Citizen_(Greece),	<Liberals_(Canada)>
<Return_release_person(s)>Indigenous_People_(Israel),	<National_Coalition_for_Syrian_Revolutionary_and_Opposition_Forces>
<Consult>Qatar_Investment_Authority,	<Martin_Spegelj>
<Arrest_detain_or_charge_with_legal_action>Men_(Mexico),	<Héctor_Beltrán_Leyva>
<Arrest_detain_or_charge_with_legal_action>Lawmaker_(Turkey),	<Hezbollah>
<Accuse>Citizen_(United_Kingdom),<Arrest_detain_or_charge_with_legal_action>Charles_Taylor,	<Foreign_Affairs_(India)>
<Return_release_person(s)>Citizen_(Venezuela),	<Social_Democratic_Union>
<Criticize_or_denounce>Alexis_Tsipras,	<Pakistan_Tehreek-e-Insaf>
<Consult>Abdullah_Abdullah,	<Justice_Department/Ministery_(Philippines)>
<Consult>Nuri_al-Maliki,	<Iraq>
<Make_a_visit>Angola,	<Government_(Sudan)>
<Bring_lawsuit_against>Oluṣẹgun_Ọbasanjọ,	<Government_(Kenya)>
<Consult>Shaukat_Aziz,	<Federal_Police>
<Host_a_visit>Foreign_Affairs_(Israel),<Criticize_or_denounce>Vietnam,<Bring_lawsuit_against>China,<Host_a_visit>Barack_Obama,<Arrest_detain_or_charge_with_legal_action>Men_(Philippines),<Demand>Citizen_(Brunei),	<China>
<Cooperate_militarily>Attack_Craft_(Poland),<Host_a_visit>Grand_Duke_Henri,	<Kazakhstan>
<Express_intent_to_cooperate_on_judicial_matters>Philippines,<Accuse>Women_(Australia),<Use_conventional_military_force>Citizen_(Australia),<Use_tactics_of_violent_repression>Citizen_(Australia),<Arrest_detain_or_charge_with_legal_action>Medical_Personnel_(Australia),<Demand>Citizen_(Australia),<Use_conventional_military_force>Women_(Australia),	<Sue-Ellen_Kovack>
<fight_with_small_arms_and_light_weapons>Citizen_(Belgium),	<Lawyer/Attorney_(Belgium)>
<Abduct_hijack_or_take_hostage>Citizen_(Benin),	<Protester_(Thailand)>
<Confiscate_property>Women_(Egypt),	<Agence_France-Presse>
<Arrest_detain_or_charge_with_legal_action>Women_(Indonesia),<Provide_humanitarian_aid>Women_(Indonesia),	<New_Zealand>
<Arrest_detain_or_charge_with_legal_action>Criminal_(Israel),	<Republican_People's_Party>
<Arrest_detain_or_charge_with_legal_action>Children_(Jamaica),	<People_Associated_with_the_Opposition_(Albania)>
<Arrest_detain_or_charge_with_legal_action>Men_(Japan),	<Medical_Personnel_(Japan)>
<Use_conventional_military_force>University_of_Nairobi,<Abduct_hijack_or_take_hostage>Member_of_Legislative_(Govt)_(Kenya),<Impose_administrative_sanctions>Citizen_(Kenya),<Make_an_appeal_or_request>Government_(Kenya),<Consult>Head_of_Government_(Kenya),	<Immigrants_(Ethiopia)>
<Investigate>Men_(New_Zealand),<Discuss_by_telephone>Maurice_Williamson,	<Cleric_(Pakistan)>
<fight_with_small_arms_and_light_weapons>Children_(Philippines),	<National_Police>
<Investigate>Citizen_(Brazil),	<Fighter_Bomber_(Iran)>
<Accuse>Businessperson_(South_Africa),<Provide_humanitarian_aid>South_Africa,<Provide_humanitarian_aid>Men_(South_Africa),	<Romania>
<Investigate>Citizen_(South_Korea),	<Student_(South_Korea)>
<Arrest_detain_or_charge_with_legal_action>Children_(Uganda),<Provide_humanitarian_aid>Citizen_(Uganda),	<Priest_(Uganda)>
<Express_intent_to_meet_or_negotiate>Middle_East,<Make_a_visit>South_Korea,<Make_a_visit>Middle_East,<Make_an_appeal_or_request>Government_(Holy_See_(Vatican_City_State)),	<South_Korea>
<Consult>Cape_Verde,	<Police_(Bulgaria)>
<Demand>Jatuporn_Prompan,	<Insurgent_(Thailand)>
<Obstruct_passage_block>Government_(Georgia),<Demonstrate_for_leadership_change>Government_(Georgia),	<Ethiopia>
<Demonstrate_or_rally>Military_(Thailand),	<Thaksin_Shinawatra>
<Demonstrate_or_rally>China,<Protest_violently_riot>China,	<Ri_Su_Yong>
<Arrest_detain_or_charge_with_legal_action>Head_of_Government_(Peru),	<Abu_Sayyaf>
<Engage_in_negotiation>Sergey_Viktorovich_Lavrov,	<Ukrinform>
<Consult>Massoud_Barzani,	<Ashraf_Ghani_Ahmadzai>
<Consult>Head_of_Government_(Nigeria),<Engage_in_negotiation>Oluṣẹgun_Ọbasanjọ,	<Criminal_(Jamaica)>
<Consult>Igor_Ivanovich_Shuvalov,	<Military_Personnel_(Lebanon)>
<Engage_in_negotiation>Faruk_Celik,	<Antonio_Guerrero_Rodríguez>
<Discuss_by_telephone>Foreign_Affairs_(United_States),<Consult>Head_of_Government_(Ethiopia),	<Umar_al_Bashir>
<Make_an_appeal_or_request>China,	<China>
<Sign_formal_agreement>National_Liberation_Army,	<Civic_Group_(Argentina)>
<Host_a_visit>Joseph_Robinette_Biden,<Host_a_visit>European_Parliament,	<Austria_Press_Agency>
<Make_an_appeal_or_request>Citizen_(Nigeria),	<Foreign_Affairs_(United_States)>
<Demand>Ministry_(Vietnam),	<National_Police>
<Reject>Morgan_Tsvangirai,	<Employee_(Philippines)>
<Consult>Miroslav_Lajcak,<Consult>Head_of_Government_(Peru),<Engage_in_negotiation>Foreign_Affairs_(Slovakia),<Express_intent_to_meet_or_negotiate>Karl_Erjavec,	<ITAR_TASS>
<Reduce_relations>Georgian_Labour_Party,	<Israeli_Defense_Forces>
<Make_an_appeal_or_request>Citizen_(India),	<Employee_(India)>
<Host_a_visit>Ministry_(Kuwait),	<Nurse_(France)>
<Make_a_visit>Japan,<Express_intent_to_meet_or_negotiate>Japan,	<Member_of_Parliament_(Bangladesh)>
<Express_intent_to_cooperate>Joseph_Robinette_Biden,	<Ministry_(Jordan)>
<Praise_or_endorse>Villager_(India),	<Raj_Thackeray>
<Consult>International_Monetary_Fund,	<Police_(Namibia)>
<Consult>Foreign_Affairs_(Ethiopia),	<Poland>
<Make_pessimistic_comment>Al-Shabaab,	<Armed_Forces_of_the_Republic_of_Armenia>
<Consult>Iran,	<Party_Member_(Malawi)>
<Accuse>Coalition_of_the_Radical_Left,	<Terrorist_Leader_(Syria)>
<Praise_or_endorse>Kumba_Ialá,	<Tahirul_Qadri>
<Make_optimistic_comment>Richard_Sulík,	<Daniel_Barrera_Barrera>
<Engage_in_diplomatic_cooperation>China,<Make_empathetic_comment>North_Korea,<Threaten>North_Korea,<Make_an_appeal_or_request>Indigenous_People_(North_Korea),<Host_a_visit>Barack_Obama,	<North_Korea>
<Consult>Foreign_Affairs_(Georgia),	<Militant_(Yemen)>
<Consult>Mohammad_Javad_Zarif,	<Nigerian_Bar_Association>
<Physically_assault>Citizen_(India),	<Ministry_(Afghanistan)>
<Arrest_detain_or_charge_with_legal_action>Citizen_(Sudan),<Host_a_visit>Isaias_Afewerki,	<Benazir_Bhutto>
<Engage_in_diplomatic_cooperation>China,<Consult>Afghanistan,	<Turkish_Airlines>
<Engage_in_diplomatic_cooperation>Citizen_(India),	<Criminal_(Australia)>
<Abduct_hijack_or_take_hostage>Citizen_(Nigeria),	<Combatant_(Turkey)>
<Praise_or_endorse>Coup_D'etat_Leader_(Thailand),<Use_conventional_military_force>Citizen_(Thailand),	<Cambodia>
<Make_a_visit>Japan,<Make_an_appeal_or_request>National_Council_for_Peace_and_Order_of_Thailand,	<Tamerlan_Tsarnaev>
<Host_a_visit>William_Ruto,<Make_an_appeal_or_request>UN_Security_Council,	<Immigrants_(Ethiopia)>
<Make_an_appeal_or_request>Citizen_(India),	<Cristina_Fernández_de_Kirchner>
<Make_a_visit>Myanmar,	<Armed_Gang_(Egypt)>
<Make_a_visit>Portugal,	<Other_Authorities_/_Officials_(Switzerland)>
<Express_intent_to_meet_or_negotiate>Businessperson_(United_States),	<Armed_Gang_(Lebanon)>
<Consult>Media_Personnel_(Greece),	<Other_Authorities_/_Officials_(Greece)>
<Consult>Xi_Jinping,	<Japan>
<Consult>John_Kerry,	<Treasury/Finance_Ministry_(Czech_Republic)>
<Appeal_for_change_in_institutions_regime>Iraq,<Engage_in_diplomatic_cooperation>Other_Authorities_/_Officials_(Somalia),<Praise_or_endorse>Peacekeeping_Troop_(Africa),	<Sudan>
<Arrest_detain_or_charge_with_legal_action>Al-Shabaab,	<Thief_(India)>
<Consult>Riek_Machar,<Make_a_visit>South_Africa,<Praise_or_endorse>China,	<William_Ruto>
<Appeal_for_diplomatic_cooperation_(such_as_policy_support)>Citizen_(Nigeria),	<Azores>
<Accuse>Qatar,<Host_a_visit>Pope_Tawadros_II,<Sign_formal_agreement>South_Korea,<Express_intent_to_meet_or_negotiate>Iran,	<Raúl_Castro>
<Make_an_appeal_or_request>African_Union,	<New_Zealand>
<Consult>Martin_Stropnický,	<Head_of_Government_(Latvia)>
<Host_a_visit>Barack_Obama,	<Sheikh_Ali_Salman>
<Engage_in_diplomatic_cooperation>China,<Express_intent_to_engage_in_diplomatic_cooperation_(such_as_policy_support)>China,<Host_a_visit>Businessperson_(Taiwan),<Threaten>China,<Express_intent_to_cooperate>Businessperson_(Philippines),<Sign_formal_agreement>China,<Criticize_or_denounce>China,	<Police_(Indonesia)>
<Express_intent_to_meet_or_negotiate>The_Hague,	<Government_(Kenya)>
<Demand_diplomatic_cooperation_(such_as_policy_support)>China,<Make_an_appeal_or_request>China,<Make_a_visit>China,	<China>
<Make_a_visit>Afghanistan,	<Government_(Venezuela)>
<Consult>Irakli_Alasania,	<Armed_Forces_of_the_Republic_of_Armenia>
