<Somalia>	<dealsWith>	<United_Arab_Emirates>
<Billy_Davies>	<isAffiliatedTo>	<Nottingham_Forest_F.C.>
<Martin_Nash_(soccer)>	<isCitizenOf>	<England>
<Traianos_Dellas>	<isAffiliatedTo>	<Atromitos_F.C.>
<Richard_Jenkins>	<actedIn>	<The_Cabin_in_the_Woods>
<63rd_Academy_Awards>	<isCitizenOf>	<Iran>
<Anne_Bancroft>	<isMarriedTo>	<Mel_Brooks>
<Christian_Eduardo_Giménez>	<isAffiliatedTo>	<Hertha_BSC>
<Alan_Rickman>	<isCitizenOf>	<Wales>
<Rabindranath_Tagore>	<isCitizenOf>	<Russia>
<Carlo_Nash>	<isAffiliatedTo>	<Wolverhampton_Wanderers_F.C.>
<State_of_Mexico>	<isCitizenOf>	<Hungary>
<Julie_Christie>	<isCitizenOf>	<England>
<Colin_Gordon_(footballer)>	<playsFor>	<Leicester_City_F.C.>
<SkyTeam>	<isLocatedIn>	<Netherlands>
<Ginger_Rogers>	<isCitizenOf>	<Kazakhstan>
<General_Dynamics>	<isLocatedIn>	<Fairfax_County,_Virginia>
<Saša_Ilić_(footballer,_born_1972)>	<isCitizenOf>	<Bangladesh>
<Russian_Empire>	<participatedIn>	<War_of_the_Fourth_Coalition>
<Harry_Connick_Jr.>	<isCitizenOf>	<England>
<Phil_Stant>	<isCitizenOf>	<Slovenia>
<Larenz_Tate>	<isCitizenOf>	<Croatia>
<Chris_Arthur>	<isCitizenOf>	<Bulgaria>
<Leroy_Chambers>	<wasBornIn>	<Sheffield>
<Angela_Lansbury>	<hasWonPrize>	<Laurence_Olivier_Award>
<Groucho_Marx>	<influences>	<Brendon_Small>
<Leroy_Lita>	<isCitizenOf>	<United_Arab_Emirates>
<Elizabeth_Taylor>	<isCitizenOf>	<England>
<Orlando_Engelaar>	<isCitizenOf>	<Sweden>
<Evan_Rachel_Wood>	<actedIn>	<The_Wrestler_(2008_film)>
<Paulo_Costa_(footballer)>	<isCitizenOf>	<Greece>
<Van_Nuys>	<isCitizenOf>	<Australia>
<Hans_Zimmer>	<wroteMusicFor>	<The_Da_Vinci_Code_(film)>
<Carl_Bradshaw_(footballer)>	<isAffiliatedTo>	<Manchester_City_F.C.>
<Bridesmaids_(2011_film)>	<isLocatedIn>	<United_States>
<Cicely_Tyson>	<wasBornIn>	<New_York_City>
<FC_Zenit_Saint_Petersburg>	<isCitizenOf>	<Wales>
<Tina_Fey>	<isCitizenOf>	<Greece>
<Michael_Spillane_(footballer)>	<isCitizenOf>	<Republic_of_the_Congo>
<Kevin_McLeod_(footballer)>	<isAffiliatedTo>	<Everton_F.C.>
<Robert_Silverberg>	<hasWonPrize>	<Nebula_Award>
<Bow_Wow_(rapper)>	<isCitizenOf>	<United_States>
<45th_Annual_Grammy_Awards>	<isCitizenOf>	<Cyprus>
<Sam_Jennings>	<isAffiliatedTo>	<West_Ham_United_F.C.>
<Sam_Neill>	<actedIn>	<Evil_Angels_(film)>
<Mark_Danks>	<isCitizenOf>	<United_Kingdom>
<Alfie_Conn_Jr.>	<isAffiliatedTo>	<Blackpool_F.C.>
<Greece>	<isCitizenOf>	<Scotland>
<Tomasz_Cywka>	<isCitizenOf>	<England>
<CBS_Corporation>	<isCitizenOf>	<Scotland>
<Paul_Musselwhite>	<isAffiliatedTo>	<Portsmouth_F.C.>
<Danny_Coyne>	<isAffiliatedTo>	<Middlesbrough_F.C.>
<Elia_Kazan>	<directed>	<On_the_Waterfront>
<Joe_Pasternak>	<wasBornIn>	<Austria-Hungary>
<United_States>	<isCitizenOf>	<Bangladesh>
<Percy_Whipp>	<playsFor>	<Swindon_Town_F.C.>
<Bill_Pullman>	<actedIn>	<Lucky_Numbers>
<Serbia>	<isCitizenOf>	<Cape_Verde>
<Milwaukee_County,_Wisconsin>	<isCitizenOf>	<Mali>
<Frankie_Sutherland>	<isCitizenOf>	<Greece>
<Nathan_Koo-Boothe>	<playsFor>	<Farnborough_F.C.>
<Jeff_Whitley>	<isCitizenOf>	<Japan>
<Kingdom_of_Romania>	<isCitizenOf>	<Chile>
<Orange_County,_California>	<isCitizenOf>	<Norway>
<Tom_Heaton>	<isCitizenOf>	<Russia>
<Leonard_Nimoy>	<isCitizenOf>	<Jamaica>
<Ernie_Watkins_(footballer,_born_1898)>	<isAffiliatedTo>	<Fulham_F.C.>
<Tobey_Maguire>	<isCitizenOf>	<United_States>
<John_Lowey_(footballer)>	<isAffiliatedTo>	<Manchester_United_F.C.>
<David_Beckham>	<isCitizenOf>	<Jamaica>
<Greece>	<participatedIn>	<Nicaraguan_Revolution>
<Carl_Bradshaw_(footballer)>	<isCitizenOf>	<India>
<War_of_the_First_Coalition>	<happenedIn>	<Kingdom_of_Great_Britain>
<Dominic_West>	<actedIn>	<Hannibal_Rising_(film)>
<Columbia,_South_Carolina>	<isLocatedIn>	<South_Carolina>
<John_Michael_Higgins>	<actedIn>	<Evan_Almighty>
<Enrico_Fermi>	<isCitizenOf>	<United_States>
<E._G._Marshall>	<isCitizenOf>	<United_States>
<Danny_Elfman>	<isCitizenOf>	<Bangladesh>
<Ryan_Burge>	<isCitizenOf>	<Brazil>
<Young_Adam_(film)>	<isLocatedIn>	<United_Kingdom>
<Sam_Jennings>	<isCitizenOf>	<Chile>
<Tommy_Chong>	<wasBornIn>	<Edmonton>
<Saint_Petersburg_State_University>	<isLocatedIn>	<Saint_Petersburg>
<Jonson_Clarke-Harris>	<isCitizenOf>	<Norway>
<Julia_Stiles>	<graduatedFrom>	<Columbia_University>
<The_Rainmaker_(1997_film)>	<isCitizenOf>	<Greece>
<Sylvia_Sidney>	<diedIn>	<New_York>
<I_Love_You_Phillip_Morris>	<isLocatedIn>	<United_States>
<Denmark>	<dealsWith>	<United_States>
<El_Salvador>	<isCitizenOf>	<India>
<Dougie_Freedman>	<isAffiliatedTo>	<Southend_United_F.C.>
<Hartford_Wolf_Pack>	<isCitizenOf>	<Croatia>
<War_of_the_Fourth_Coalition>	<happenedIn>	<Germany>
<Adi_Yussuf>	<isCitizenOf>	<Tanzania>
<Chris_Crowe>	<isCitizenOf>	<Russia>
<The_Vow_(2012_film)>	<isLocatedIn>	<United_States>
<James_Rebhorn>	<isCitizenOf>	<Croatia>
<József_Viola>	<isAffiliatedTo>	<Vicenza_Calcio>
<John_McGuigan>	<isCitizenOf>	<Barbados>
<Loïc_Rémy>	<playsFor>	<Olympique_Lyonnais>
<Ian_James_Corlett>	<livesIn>	<Palm_Springs,_California>
<The_Walt_Disney_Company>	<isCitizenOf>	<Croatia>
<Saint_Petersburg_State_University>	<isCitizenOf>	<Wales>
<Carter_Burwell>	<wroteMusicFor>	<Velvet_Goldmine>
<Ismaïl_Aissati>	<isAffiliatedTo>	<SBV_Vitesse>
<John_Guidetti>	<isAffiliatedTo>	<Celtic_F.C.>
<Ghana>	<isCitizenOf>	<Israel>
<Dave_Mackay>	<isCitizenOf>	<Scotland>
<Darren_Byfield>	<isAffiliatedTo>	<Millwall_F.C.>
<Jon_Newby>	<isCitizenOf>	<Martinique>
<Gustave_Flaubert>	<influences>	<George_Orwell>
<Tom_Cowan>	<isCitizenOf>	<Cyprus>
<Eli_Wallach>	<isCitizenOf>	<Hungary>
<Fred_Pagnam>	<playsFor>	<Watford_F.C.>
<Electric_Daisy_Carnival>	<isLocatedIn>	<Dallas>
<2009_Sundance_Film_Festival>	<isCitizenOf>	<Greece>
<Joe_Bradshaw_(footballer)>	<isAffiliatedTo>	<Fulham_F.C.>
<Jack_Warden>	<actedIn>	<Bulworth>
<Austria-Hungary>	<isCitizenOf>	<France>
<Kari_Wahlgren>	<livesIn>	<Los_Angeles>
<Vera_Drake>	<isCitizenOf>	<Brazil>
<Law_&_Order>	<isCitizenOf>	<Bulgaria>
<Sierra_Entertainment>	<isCitizenOf>	<Germany>
<Arthur_Phoenix>	<playsFor>	<Shelbourne_F.C.>
<Emerson_Thome>	<isCitizenOf>	<China>
<Chris_Cooper>	<isCitizenOf>	<Poland>
<Lee_Peltier>	<isCitizenOf>	<Spain>
<Shlomi_Arbeitman>	<isCitizenOf>	<Republic_of_Ireland>
<Harry_Gregson-Williams>	<isCitizenOf>	<Brazil>
<Youssouf_Hersi>	<isAffiliatedTo>	<Perth_Glory_FC>
<Robert_De_Niro>	<isCitizenOf>	<Netherlands>
<Lee_McEvilly>	<isCitizenOf>	<Iran>
<Cristian_Montaño>	<isCitizenOf>	<Mali>
<Novak_Djokovic>	<isCitizenOf>	<Tanzania>
<Karim_Rekik>	<wasBornIn>	<The_Hague>
<Carmine_Gautieri>	<isAffiliatedTo>	<A.S._Livorno_Calcio>
<30_Days_of_Night_(film)>	<isCitizenOf>	<Ukraine>
<The_Culinary_Institute_of_America>	<isLocatedIn>	<New_York>
<Mali>	<isCitizenOf>	<France>
<Woody_Allen>	<isCitizenOf>	<Russia>
<Jamaica>	<isCitizenOf>	<Norway>
<Héctor_Rial>	<isCitizenOf>	<El_Salvador>
<Eminem>	<wasBornIn>	<St._Joseph,_Missouri>
<Colin_Cramb>	<isCitizenOf>	<Scotland>
<Martin_Nash_(soccer)>	<isCitizenOf>	<Canada>
<Barry_Robson>	<isCitizenOf>	<Kazakhstan>
<David_Ogden_Stiers>	<actedIn>	<The_Hunchback_of_Notre_Dame_(1996_film)>
<Emerson_(footballer,_born_1972)>	<isCitizenOf>	<Cyprus>
<Thomas_Brodie-Sangster>	<isCitizenOf>	<El_Salvador>
<Scott_Loach>	<isCitizenOf>	<United_Arab_Emirates>
<Steve_Taylor_(footballer)>	<isCitizenOf>	<England>
<Colin_Cramb>	<isAffiliatedTo>	<Bristol_City_F.C.>
<Noel_Hunt>	<isCitizenOf>	<Republic_of_Ireland>
<Somalia>	<isCitizenOf>	<Nigeria>
<John_Guidetti>	<isAffiliatedTo>	<Manchester_City_F.C.>
<Clyde_Wijnhard>	<isCitizenOf>	<Senegal>
<Alex_Gibney>	<graduatedFrom>	<Yale_University>
<René_Descartes>	<graduatedFrom>	<Leiden_University>
<Diego_Perrone>	<isCitizenOf>	<Panama>
<Milan>	<owns>	<A.C._Milan>
<Vietnam>	<isCitizenOf>	<Dominica>
<Tom_Flanagan_(footballer)>	<isAffiliatedTo>	<Barnet_F.C.>
<Peter_Shilton>	<isCitizenOf>	<Democratic_Republic_of_the_Congo>
<Alan_Bennett_(footballer,_born_1981)>	<isAffiliatedTo>	<Cheltenham_Town_F.C.>
<Kevin_Dearden>	<isCitizenOf>	<Wales>
<Fred_Pagnam>	<isCitizenOf>	<Barbados>
<Terrence_McNally>	<hasWonPrize>	<Tony_Award>
<Jason_Banton>	<isAffiliatedTo>	<Milton_Keynes_Dons_F.C.>
<Henri_Lansbury>	<isAffiliatedTo>	<Nottingham_Forest_F.C.>
<Nicolas_Cage>	<actedIn>	<Face/Off>
<Edward_Norton>	<isCitizenOf>	<China>
<Peter_Swan_(footballer,_born_1966)>	<isCitizenOf>	<Scotland>
<Poland>	<hasNeighbor>	<Ukraine>
<Luke_Daniels>	<isCitizenOf>	<England>
<Jason_Lee_(footballer)>	<isAffiliatedTo>	<Nottingham_Forest_F.C.>
<Kingston_upon_Hull>	<isCitizenOf>	<Hungary>
<Vladimir_Petrović>	<isAffiliatedTo>	<Red_Star_Belgrade>
<El_Salvador>	<dealsWith>	<China>
<The_Haunting_(1999_film)>	<isLocatedIn>	<United_States>
<Joseph_S._O'Leary>	<isCitizenOf>	<Martinique>
<Fred_Bevan>	<playsFor>	<Bury_F.C.>
<Jason_van_Blerk>	<isAffiliatedTo>	<Millwall_F.C.>
<Abigail_Breslin>	<isCitizenOf>	<Mali>
<Amelia_(film)>	<isLocatedIn>	<Canada>
<Ray_Hankin>	<isCitizenOf>	<England>
<Citrus_County,_Florida>	<isCitizenOf>	<Monaco>
<Lesser_Antilles>	<isLocatedIn>	<Anguilla>
<Glen_Southam>	<isCitizenOf>	<Serbia>
<Brett_Angell>	<isAffiliatedTo>	<Walsall_F.C.>
<Randy_Travis>	<isCitizenOf>	<United_States>
<Don_Knotts>	<isCitizenOf>	<Republic_of_Ireland>
<Ravi_Shankar>	<isCitizenOf>	<Slovenia>
<Mike_Stowell>	<isCitizenOf>	<Belgium>
<Esteban_Cambiasso>	<wasBornIn>	<Buenos_Aires>
<Lucien_Ballard>	<isCitizenOf>	<United_States>
<César_Prates>	<isAffiliatedTo>	<A.C._ChievoVerona>
<Diane_Warren>	<hasWonPrize>	<APRA_Awards_(Australia)>
<Danny_Andrew>	<playsFor>	<Macclesfield_Town_F.C.>
<Emanuele_Pesaresi>	<isCitizenOf>	<Bahrain>
<Brian_Kidd>	<isCitizenOf>	<Italy>
<Chris_Withe>	<isCitizenOf>	<England>
<Jérôme_Leroy_(footballer)>	<isAffiliatedTo>	<FC_Istres>
<Jamie_Day_(footballer,_born_1979)>	<isAffiliatedTo>	<Ebbsfleet_United_F.C.>
<Robert_F._Kennedy>	<isCitizenOf>	<Mali>
<Dennis_Bailey_(footballer,_born_1965)>	<isAffiliatedTo>	<Birmingham_City_F.C.>
<Rory_Fallon>	<isAffiliatedTo>	<Barnsley_F.C.>
<David_O._Russell>	<isCitizenOf>	<Martinique>
<Reece_Styche>	<isCitizenOf>	<Argentina>
<Stephen_Dawson>	<isAffiliatedTo>	<Mansfield_Town_F.C.>
<Matteo_Brighi>	<playsFor>	<A.C._ChievoVerona>
<Ryan_McCann>	<isCitizenOf>	<United_Kingdom>
<Vince_Gilligan>	<hasWonPrize>	<Writers_Guild_of_America_Award>
<Nathan_Koo-Boothe>	<isCitizenOf>	<Serbia>
<Bob_Hatton>	<isCitizenOf>	<England>
<Stark_County,_Ohio>	<isLocatedIn>	<Canton,_Ohio>
<Donal_Murphy>	<isAffiliatedTo>	<Shelbourne_F.C.>
<Rick_Kline>	<isCitizenOf>	<United_States>
<Chicago_metropolitan_area>	<isLocatedIn>	<Elgin,_Illinois>
<1932_Summer_Olympics>	<isLocatedIn>	<Los_Angeles>
<Jon_Parkin>	<playsFor>	<Cardiff_City_F.C.>
<Tom_Arnold_(actor)>	<isCitizenOf>	<India>
<Lawrence_Kasdan>	<isCitizenOf>	<Cameroon>
<Richard_Chamberlain>	<isCitizenOf>	<Norway>
<Gregor_Rioch>	<isCitizenOf>	<Cameroon>
<Djibril_Cissé>	<isCitizenOf>	<Nigeria>
<Harvey_Weinstein>	<created>	<The_Weinstein_Company>
<Lawrence_Kasdan>	<directed>	<Wyatt_Earp_(film)>
<Eastern_Kentucky_University>	<isLocatedIn>	<Kentucky>
<Antonio_Banderas>	<isCitizenOf>	<Mali>
<Ramón_Núñez>	<isAffiliatedTo>	<Puebla_F.C.>
<Damon_Lindelof>	<isCitizenOf>	<Scotland>
<Michael_Shannon>	<actedIn>	<Take_Shelter>
<Leroy_Chambers>	<isCitizenOf>	<Scotland>
<Modibo_Diakité>	<isCitizenOf>	<Bahrain>
<Andy_Kennedy_(footballer,_born_1964)>	<isCitizenOf>	<Croatia>
<Rolando_Bianchi>	<isAffiliatedTo>	<Bologna_F.C._1909>
<Andy_Dow>	<wasBornIn>	<Dundee>
<Jacques_Derrida>	<influences>	<Edward_Said>
<Gérson_Magrão>	<isCitizenOf>	<Kazakhstan>
<Gary_Powell_(footballer)>	<isCitizenOf>	<Wales>
<Jonathan_Swift>	<graduatedFrom>	<Trinity_College,_Dublin>
<Chevy_Chase>	<wasBornIn>	<New_York_City>
<Douglas_Adams>	<wasBornIn>	<Cambridge>
<Ramon_Menezes>	<playsFor>	<Al-Gharafa_Sports_Club>
<Megan_Fox>	<actedIn>	<Jonah_Hex_(film)>
<Mel_Gibson>	<actedIn>	<Gallipoli_(1981_film)>
<O'Neill_Donaldson>	<isCitizenOf>	<Norway>
<Mick_Bodley>	<isCitizenOf>	<Nigeria>
<Ludwig_Wittgenstein>	<influences>	<Isaiah_Berlin>
<Giovanni_Sio>	<isAffiliatedTo>	<SC_Bastia>
<Cree_Summer>	<isCitizenOf>	<United_States>
<Leon_Russell>	<isCitizenOf>	<United_States>
<Elizabeth_Banks>	<graduatedFrom>	<University_of_Pennsylvania>
<War_of_the_Fourth_Coalition>	<isCitizenOf>	<Denmark>
<Kazakhstan>	<isCitizenOf>	<Northern_Ireland>
<Mel_Brooks>	<wasBornIn>	<Brooklyn>
<Rebecca_Hall>	<actedIn>	<The_Town_(2010_film)>
<Darren_Jackson>	<isCitizenOf>	<Scotland>
<Jim_Fryatt>	<isCitizenOf>	<Jamaica>
<Mohamed_Sissoko>	<isCitizenOf>	<Norway>
<Graham_Potter>	<playsFor>	<Stoke_City_F.C.>
<Dean_Holdsworth>	<isAffiliatedTo>	<Port_Vale_F.C.>
<Steve_Zahn>	<hasWonPrize>	<Independent_Spirit_Awards>
<Bela_Lugosi>	<isCitizenOf>	<Hungary>
<Harry_Roberts_(footballer,_born_1907)>	<isCitizenOf>	<Australia>
<Brian_Birch>	<isAffiliatedTo>	<Helsingborgs_IF>
<Mark_Hamill>	<isCitizenOf>	<India>
<Lateef_Elford-Alliyu>	<isCitizenOf>	<Niger>
<Saddam_Hussein>	<isPoliticianOf>	<Iraq>
<Bill_McGarry>	<isAffiliatedTo>	<Huddersfield_Town_A.F.C.>
<New_Zealand>	<isCitizenOf>	<United_States>
<David_Beckham>	<isAffiliatedTo>	<England_national_football_team>
<Larry_Fine>	<diedIn>	<Los_Angeles>
<Mychael_Danna>	<wroteMusicFor>	<Girl,_Interrupted_(film)>
<Niels_Bohr>	<wasBornIn>	<Copenhagen>
<Rashida_Jones>	<isCitizenOf>	<Dominica>
<Simon_Gillett>	<isAffiliatedTo>	<Southampton_F.C.>
<21st_Academy_Awards>	<isLocatedIn>	<United_States>
<Hartford_Wolf_Pack>	<isLocatedIn>	<Hartford,_Connecticut>
<Gary_Shelton>	<isCitizenOf>	<Cameroon>
<Graham_Greene_(actor)>	<isCitizenOf>	<Jamaica>
<Billy_Davies>	<isCitizenOf>	<Dominica>
<Laurent_Robert>	<isCitizenOf>	<China>
<Amartya_Sen>	<livesIn>	<New_York>
<Pakistan>	<isCitizenOf>	<India>
<Rihanna>	<isCitizenOf>	<Barbados>
<Sanctuary_Records>	<isLocatedIn>	<England>
<Keith_Edwards_(footballer,_born_1957)>	<isCitizenOf>	<Wales>
<Luftwaffe>	<isCitizenOf>	<Northern_Ireland>
<Tajikistan>	<isCitizenOf>	<Democratic_Republic_of_the_Congo>
<Graham_Roberts>	<isAffiliatedTo>	<West_Bromwich_Albion_F.C.>
<Axis_powers>	<participatedIn>	<World_War_II>
<Youngstown,_Ohio>	<isCitizenOf>	<France>
<Union_of_South_Africa>	<participatedIn>	<Korean_War>
<Daniel_Nardiello>	<isAffiliatedTo>	<Plymouth_Argyle_F.C.>
<Alberto_Gilardino>	<isCitizenOf>	<Italy>
<William_Thomson,_1st_Baron_Kelvin>	<livesIn>	<Cambridge>
<Jack_Reynolds_(footballer,_born_1869)>	<isCitizenOf>	<Belgium>
<Peter_Gilbert>	<isCitizenOf>	<France>
<Karl_Ready>	<isCitizenOf>	<United_States>
<Jon_Macken>	<isCitizenOf>	<Tanzania>
<General_Electric>	<isCitizenOf>	<Serbia>
<Edward_G._Robinson>	<isCitizenOf>	<China>
<Sam_Jennings>	<playsFor>	<Burnley_F.C.>
<Lomana_LuaLua>	<isCitizenOf>	<England>
<Dele_Adebola>	<isAffiliatedTo>	<Bristol_City_F.C.>
<Charles_Brackett>	<isCitizenOf>	<Iran>
<Cyndi_Lauper>	<isCitizenOf>	<Germany>
<Mandatory_Palestine>	<participatedIn>	<Italian_Campaign_(World_War_II)>
<Nathan_Byrne>	<isCitizenOf>	<Wales>
<Alex_Borstein>	<wasBornIn>	<Highland_Park,_Illinois>
<Sid_Jones>	<isCitizenOf>	<England>
<Jon_Shaw>	<isAffiliatedTo>	<Mansfield_Town_F.C.>
<Elizabeth_McGovern>	<wasBornIn>	<Evanston,_Illinois>
<Mark_Nicholls>	<playsFor>	<Partick_Thistle_F.C.>
<Don_Weston>	<isAffiliatedTo>	<Altrincham_F.C.>
<Jayne_Mansfield>	<isCitizenOf>	<England>
<Jennifer_Connelly>	<isCitizenOf>	<England>
<Seol_Ki-hyeon>	<isCitizenOf>	<England>
<Branco_(footballer)>	<isCitizenOf>	<Puerto_Rico>
<India>	<participatedIn>	<Operation_Enduring_Freedom_–_Horn_of_Africa>
<Julian_Alsop>	<isCitizenOf>	<France>
<Josh_Wright>	<isAffiliatedTo>	<Charlton_Athletic_F.C.>
<Bertrand_Bossu>	<isAffiliatedTo>	<Gillingham_F.C.>
<Judi_Dench>	<isCitizenOf>	<Martinique>
<Martin_O'Neill>	<isCitizenOf>	<Republic_of_Ireland>
<Pim_Verbeek>	<isCitizenOf>	<Australia>
<Chicago_metropolitan_area>	<isCitizenOf>	<Kazakhstan>
<Canada>	<isCitizenOf>	<Puerto_Rico>
<Raúl_Díaz_Arce>	<playsFor>	<San_Jose_Earthquakes>
<Michael_Spies>	<isCitizenOf>	<Greece>
<Colin_Hendry>	<isAffiliatedTo>	<Blackpool_F.C.>
<Diane_Keaton>	<isCitizenOf>	<Germany>
<Ramón_Núñez>	<isCitizenOf>	<Argentina>
<Rosario_Dawson>	<wasBornIn>	<New_York_City>
<Ronald_D._Moore>	<isCitizenOf>	<United_States>
<Shirley_Ann_Russell>	<isCitizenOf>	<United_Kingdom>
<Armand_Assante>	<actedIn>	<American_Gangster_(film)>
<Ian_Hendon>	<isAffiliatedTo>	<Northampton_Town_F.C.>
<Darius_Henderson>	<isAffiliatedTo>	<Mansfield_Town_F.C.>
<Timothy_Spall>	<isCitizenOf>	<England>
<Peter_Taylor_(footballer,_born_1953)>	<isAffiliatedTo>	<Wycombe_Wanderers_F.C.>
<St._Louis_Blues>	<isLocatedIn>	<Missouri>
<John_Roberts_(footballer,_born_1946)>	<isCitizenOf>	<India>
<New_Rochelle,_New_York>	<isCitizenOf>	<Argentina>
<Will_Ferrell>	<actedIn>	<Bewitched_(2005_film)>
<Aruna_Irani>	<isCitizenOf>	<Nigeria>
<Lee_Chapman>	<isCitizenOf>	<Italy>
<Paul_Allen_(footballer)>	<isAffiliatedTo>	<West_Ham_United_F.C.>
<Berkshire>	<isCitizenOf>	<Austria>
<Lewis_Montrose>	<isCitizenOf>	<Hungary>
<Gavin_Heeroo>	<playsFor>	<Grays_Athletic_F.C.>
<Vinny_Arkins>	<isCitizenOf>	<Republic_of_Ireland>
<Kelly_Preston>	<actedIn>	<Jerry_Maguire>
<Steve_Leo_Beleck>	<playsFor>	<ACF_Fiorentina>
<Lee_Fowler>	<isAffiliatedTo>	<Kidderminster_Harriers_F.C.>
<Noah_Wyle>	<isCitizenOf>	<Russia>
<George_Berry_(footballer)>	<isAffiliatedTo>	<Stoke_City_F.C.>
<Scouting_in_California>	<isLocatedIn>	<Sacramento,_California>
<Ottoman_Empire>	<isCitizenOf>	<Niger>
<Enrico_Fermi>	<worksAt>	<Columbia_University>
<Peter_Taylor_(footballer,_born_1953)>	<isCitizenOf>	<Netherlands>
<Fred_Williamson>	<actedIn>	<From_Dusk_till_Dawn>
<John_van_Loen>	<isCitizenOf>	<Belgium>
<Ludacris>	<isCitizenOf>	<United_States>
<David_Ogden_Stiers>	<isCitizenOf>	<Netherlands>
<Peter_Shilton>	<wasBornIn>	<Leicester>
<Milan>	<isCitizenOf>	<Cape_Verde>
<Tim_Blake_Nelson>	<wasBornIn>	<Tulsa,_Oklahoma>
<Denmark>	<participatedIn>	<Kosovo_War>
<Song_Chong-gug>	<isAffiliatedTo>	<South_Korea_national_football_team>
<Trésor_Kandol>	<isAffiliatedTo>	<Millwall_F.C.>
<Vladimir_Petrović>	<isCitizenOf>	<Nigeria>
<Abel_Xavier>	<isAffiliatedTo>	<Middlesbrough_F.C.>
<UEFA>	<isLocatedIn>	<Europe>
<Wayne_Biggins>	<isCitizenOf>	<Germany>
<Tony_Thomas_(producer)>	<isCitizenOf>	<United_States>
<Russian_Empire>	<isCitizenOf>	<India>
<Daniel_Dennett>	<isCitizenOf>	<United_States>
<Snoop_Dogg>	<isCitizenOf>	<Monaco>
<Ray_Haddington>	<isCitizenOf>	<Tanzania>
<Nathan_Byrne>	<isAffiliatedTo>	<Wolverhampton_Wanderers_F.C.>
<Alex_Cisak>	<isCitizenOf>	<Switzerland>
<Tim_Sherwood>	<isAffiliatedTo>	<Coventry_City_F.C.>
<Lucas_Silva_(footballer,_born_1984)>	<isAffiliatedTo>	<Tiburones_Rojos_de_Veracruz>
<Willem_Dafoe>	<actedIn>	<Mississippi_Burning>
<Luciano_Figueroa>	<playsFor>	<Genoa_C.F.C.>
<Koei_Tecmo>	<isCitizenOf>	<Senegal>
<Stefano_Lombardi>	<isAffiliatedTo>	<A.C._Perugia_Calcio>
<Confederate_States_of_America>	<participatedIn>	<American_Civil_War>
<Georg_Wilhelm_Friedrich_Hegel>	<isCitizenOf>	<Belgium>
<Orlando_Engelaar>	<isAffiliatedTo>	<K.R.C._Genk>
<Girl,_Interrupted_(film)>	<isLocatedIn>	<United_States>
<Saddam_Hussein>	<isCitizenOf>	<Japan>
<Jyothika>	<hasWonPrize>	<Filmfare_Awards_South>
<James_Wallace_(footballer,_born_1991)>	<isCitizenOf>	<Bahrain>
<Wendy_Melvoin>	<created>	<Heroes_(TV_series)>
<Costa_Rica>	<isCitizenOf>	<Norway>
<Pamela_Anderson>	<isCitizenOf>	<Canada>
<In_Your_House>	<isLocatedIn>	<Florida>
<John_Michael_Higgins>	<actedIn>	<For_Your_Consideration_(film)>
<Albert_Holmes_(footballer,_born_1885)>	<isCitizenOf>	<Brazil>
<Maurizio_Iorio>	<isAffiliatedTo>	<F.C._Bari_1908>
<Ralph_Fiennes>	<actedIn>	<Sunshine_(1999_film)>
<Geoff_Scott_(footballer)>	<isAffiliatedTo>	<Cambridge_United_F.C.>
<Ned_Beatty>	<wasBornIn>	<Louisville,_Kentucky>
<Ian_Fleming>	<isCitizenOf>	<United_Kingdom>
<Angels_&_Airwaves_Presents_Love_Live>	<isLocatedIn>	<Georgia_(U.S._state)>
<Patrick_Agyemang>	<playsFor>	<Stevenage_F.C.>
<Appalachian_Mountains>	<isCitizenOf>	<El_Salvador>
<Vanderlei_Luxemburgo>	<isCitizenOf>	<China>
<Tom_Green>	<isMarriedTo>	<Drew_Barrymore>
<Dean_McDonald>	<isCitizenOf>	<Norway>
<Alan_Thompson_(footballer,_born_1973)>	<isAffiliatedTo>	<England_national_football_team>
<Ed_Asner>	<actedIn>	<Rich_Man,_Poor_Man_(miniseries)>
<Keith_Edwards_(footballer,_born_1957)>	<isAffiliatedTo>	<Stockport_County_F.C.>
<Roberto_Benigni>	<directed>	<Pinocchio_(2002_film)>
<Edward_G._Robinson>	<actedIn>	<The_Ten_Commandments_(1956_film)>
<Cary-Hiroyuki_Tagawa>	<isCitizenOf>	<United_States>
<France>	<participatedIn>	<International_Force_for_East_Timor>
<Gwen_Stefani>	<isCitizenOf>	<United_Kingdom>
<Tom_Hanks>	<isCitizenOf>	<Poland>
<Sam_Jennings>	<playsFor>	<Olympique_de_Marseille>
<Eric_Wynalda>	<isCitizenOf>	<Spain>
<Asia_Argento>	<isCitizenOf>	<Brazil>
<Lee_J._Cobb>	<isCitizenOf>	<Russia>
<Jack_Haines>	<isAffiliatedTo>	<Wrexham_A.F.C.>
<Stefano_Lombardi>	<isCitizenOf>	<Norway>
<Tom_Skerritt>	<actedIn>	<MASH_(film)>
<Union_of_South_Africa>	<isCitizenOf>	<Wales>
<Kaba_Diawara>	<isAffiliatedTo>	<Stade_Rennais_F.C.>
<Giovani_dos_Santos>	<isAffiliatedTo>	<Tottenham_Hotspur_F.C.>
<Brad_Friedel>	<isAffiliatedTo>	<United_States_men's_national_soccer_team>
<Warren_Feeney>	<isCitizenOf>	<Poland>
<James_Wallace_(footballer,_born_1991)>	<wasBornIn>	<Liverpool>
<Jack_Reynolds_(footballer,_born_1869)>	<isAffiliatedTo>	<Aston_Villa_F.C.>
<Dorothy_Fields>	<diedIn>	<New_York_City>
<Kenny_Cooper>	<isCitizenOf>	<Germany>
<Stewart_Littlewood>	<isCitizenOf>	<Chile>
<Art_Center_College_of_Design>	<isLocatedIn>	<Pasadena,_California>
<Netherlands>	<isCitizenOf>	<Bangladesh>
<Christian_Eduardo_Giménez>	<isCitizenOf>	<Netherlands>
<Martin_Hodge>	<isCitizenOf>	<Belgium>
<Asia_Argento>	<actedIn>	<Marie_Antoinette_(2006_film)>
<Art_Center_College_of_Design>	<isCitizenOf>	<Monaco>
<Tony_Scully>	<isCitizenOf>	<Denmark>
<Ismaïl_Aissati>	<isCitizenOf>	<Poland>
<Jermaine_Pennant>	<isAffiliatedTo>	<Wigan_Athletic_F.C.>
<Richard_Chamberlain>	<wasBornIn>	<Beverly_Hills,_California>
<Andy_Keogh>	<isCitizenOf>	<Senegal>
<I_Love_You_Phillip_Morris>	<isCitizenOf>	<Iran>
<Marco_Baroni>	<isAffiliatedTo>	<Delfino_Pescara_1936>
<John_Eustace>	<isAffiliatedTo>	<Coventry_City_F.C.>
<Alex_Gibney>	<isCitizenOf>	<United_States>
<State_highways_serving_Virginia_state_institutions>	<isCitizenOf>	<Panama>
<Richard_O'Donnell>	<isCitizenOf>	<Panama>
<Jack_Warden>	<isCitizenOf>	<Tanzania>
<Kari_Wahlgren>	<isCitizenOf>	<Monaco>
<Sam_Togwell>	<isCitizenOf>	<Bangladesh>
<Robert_Vaughn>	<isCitizenOf>	<United_States>
<Santa_Rosa,_California>	<isLocatedIn>	<United_States>
<Mark_Wilson_(English_footballer)>	<isAffiliatedTo>	<Walsall_F.C.>
<Arcadia,_California>	<isLocatedIn>	<Los_Angeles_County,_California>
<Romania>	<dealsWith>	<Netherlands>
<Thomas_Edison>	<isCitizenOf>	<United_States>
<Carole_Lombard>	<isCitizenOf>	<Chile>
<Iraq_War>	<happenedIn>	<Iraq>
<John_Burridge>	<playsFor>	<Manchester_City_F.C.>
<Fresno_County,_California>	<isCitizenOf>	<El_Salvador>
<Gavin_Heeroo>	<isCitizenOf>	<China>
<Martin_Paterson>	<playsFor>	<Port_Vale_F.C.>
<North_Dakota>	<isLocatedIn>	<United_States>
<Aidan_Davison>	<isCitizenOf>	<Russia>
<Kevin_Summerfield>	<isCitizenOf>	<Niger>
<Paul_Rachubka>	<isCitizenOf>	<Barbados>
<Peter_Marinello>	<isCitizenOf>	<Barbados>
<Alfred_Molina>	<isCitizenOf>	<Iran>
<Jérôme_Leroy_(footballer)>	<isCitizenOf>	<Canada>
<Emile_Hirsch>	<isCitizenOf>	<Senegal>
<Carlo_Nash>	<isCitizenOf>	<Democratic_Republic_of_the_Congo>
<John_Barnes_(footballer)>	<isCitizenOf>	<United_States>
<Joe_Johnson_(footballer,_born_1911)>	<isCitizenOf>	<Russia>
<Jeffrey_Monakana>	<isAffiliatedTo>	<Bristol_Rovers_F.C.>
<Horace_Brindley>	<playsFor>	<Norwich_City_F.C.>
<In_Your_House>	<isLocatedIn>	<Canada>
<Antony_Sher>	<hasWonPrize>	<Drama_Desk_Award>
<Bridget_Fonda>	<isCitizenOf>	<Netherlands>
<Will_Ferrell>	<isCitizenOf>	<United_States>
<Luc_Besson>	<wasBornIn>	<Paris>
<Kyle_McCulloch>	<isCitizenOf>	<United_States>
<Girl,_Interrupted_(film)>	<isCitizenOf>	<El_Salvador>
<Dominic_West>	<livesIn>	<Hammersmith>
<Richard_Walker_(footballer,_born_1977)>	<isAffiliatedTo>	<Aston_Villa_F.C.>
<Maurizio_Iorio>	<isAffiliatedTo>	<Inter_Milan>
<Richard_Dreyfuss>	<actedIn>	<The_Goodbye_Girl>
<Maicon_Santos>	<playsFor>	<FC_Dallas>
<Anthony_Pulis>	<isCitizenOf>	<Australia>
<Jake_Edwards_(footballer,_born_1976)>	<wasBornIn>	<Manchester>
<The_Culinary_Institute_of_America>	<isCitizenOf>	<Ukraine>
<Phil_Marsh>	<playsFor>	<Barrow_A.F.C.>
<Anthony_Hopkins>	<isCitizenOf>	<Bulgaria>
<Lilo_&_Stitch>	<isCitizenOf>	<El_Salvador>
<Neville_Roach>	<isCitizenOf>	<India>
<Gordon_Hill_(footballer)>	<isAffiliatedTo>	<Derby_County_F.C.>
<Kingdom_of_Naples>	<hasCapital>	<Naples>
<Ghana>	<hasOfficialLanguage>	<English_language>
<Danny_Cullip>	<isCitizenOf>	<United_Arab_Emirates>
<Billy_Manuel>	<isCitizenOf>	<Argentina>
<Westminster_School>	<isCitizenOf>	<Poland>
<Liam_Miller>	<isAffiliatedTo>	<Brisbane_Roar_FC>
<Jason_van_Blerk>	<isCitizenOf>	<Canada>
<Fraizer_Campbell>	<isCitizenOf>	<England>
<Ireland>	<participatedIn>	<United_Nations_Operation_in_Somalia_II>
<Billy_Crudup>	<graduatedFrom>	<University_of_North_Carolina_at_Chapel_Hill>
<Aldo_Duscher>	<isAffiliatedTo>	<RCD_Espanyol>
<Andy_Todd_(footballer,_born_1974)>	<isCitizenOf>	<Germany>
<Michael_Stipe>	<wasBornIn>	<Decatur,_Georgia>
<Theoni_V._Aldredge>	<isCitizenOf>	<Greece>
<Steve_Guinan>	<isCitizenOf>	<Argentina>
<Andy_O'Brien_(footballer)>	<isCitizenOf>	<Ukraine>
<Philip_Pullman>	<hasWonPrize>	<Astrid_Lindgren_Memorial_Award>
<Linda_Cardellini>	<isCitizenOf>	<Belgium>
<Emory_University>	<isLocatedIn>	<United_States>
<Fred_Bevan>	<isCitizenOf>	<Nigeria>
<21st_Academy_Awards>	<isCitizenOf>	<England>
<Rubén_González_Rocha>	<playsFor>	<FC_Baku>
<Bill_Wyman>	<isCitizenOf>	<Democratic_Republic_of_the_Congo>
<Berkshire>	<isLocatedIn>	<South_East_England>
<Traianos_Dellas>	<isCitizenOf>	<Nigeria>
<Christian_Hanson_(footballer)>	<isCitizenOf>	<Bulgaria>
<Toby_Ajala>	<isCitizenOf>	<Croatia>
<Noah_Taylor>	<isCitizenOf>	<Puerto_Rico>
<Snoop_Dogg>	<actedIn>	<Starsky_&_Hutch_(film)>
<Ivory_Coast>	<dealsWith>	<China>
<Confederate_States_of_America>	<isCitizenOf>	<Kazakhstan>
<State_highways_serving_Virginia_state_institutions>	<isLocatedIn>	<Fredericksburg,_Virginia>
<Kevin_Smith>	<created>	<Jersey_Girl_(2004_film)>
<Jocky_Wright>	<isCitizenOf>	<India>
<Elizabeth_II>	<isCitizenOf>	<Australia>
<Taking_Woodstock>	<isCitizenOf>	<Kazakhstan>
<Denver_Nuggets>	<isCitizenOf>	<Serbia>
<David_McCracken>	<isCitizenOf>	<Martinique>
<Nora_Ephron>	<isCitizenOf>	<Ukraine>
<Stuart_Parker_(footballer)>	<isCitizenOf>	<Martinique>
<2013–14_chikungunya_outbreak>	<happenedIn>	<Cayman_Islands>
<Blackpool>	<isCitizenOf>	<Ukraine>
<Sofia_Coppola>	<isCitizenOf>	<Austria>
<Will_Buckley_(footballer)>	<isAffiliatedTo>	<Leeds_United_F.C.>
<Daniel_Kearns_(footballer)>	<isCitizenOf>	<Northern_Ireland>
<Columbia_Law_School>	<isCitizenOf>	<Barbados>
<Wilson_Kamavuaka>	<isCitizenOf>	<Republic_of_the_Congo>
<Robert_F._Kennedy>	<diedIn>	<Los_Angeles>
<Ned_Beatty>	<isCitizenOf>	<Netherlands>
<Netherlands>	<participatedIn>	<Libyan_Civil_War_(2011)>
<Los_Lobos>	<isCitizenOf>	<Italy>
<Sylvester_Stallone>	<isCitizenOf>	<Chile>
<Louie_Soares>	<isCitizenOf>	<Slovenia>
<Paul_Rideout>	<isCitizenOf>	<Mali>
<Marco_Motta>	<isCitizenOf>	<Chile>
<Phil_Collins>	<isCitizenOf>	<United_Kingdom>
<Ben_Smith_(footballer,_born_1978)>	<isAffiliatedTo>	<Arsenal_F.C.>
<Bobby_Olejnik>	<isAffiliatedTo>	<Falkirk_F.C.>
<Danny_Graham_(footballer)>	<isCitizenOf>	<Slovenia>
<Salt_(2010_film)>	<isLocatedIn>	<United_States>
<Jason_Kidd>	<isCitizenOf>	<Bangladesh>
<Matt_Stone>	<hasWonPrize>	<Laurence_Olivier_Award>
<Gérson_Magrão>	<isAffiliatedTo>	<Clube_de_Regatas_do_Flamengo>
<Billy_Hendry>	<playsFor>	<Dundee_F.C.>
<Garry_Marshall>	<isCitizenOf>	<Germany>
<Rolando_Bianchi>	<isCitizenOf>	<Poland>
<Brian_Taylor_(footballer,_born_1937)>	<isAffiliatedTo>	<Shrewsbury_Town_F.C.>
<Marc_Nygaard>	<isCitizenOf>	<Belgium>
<Joni_Mitchell>	<hasWonPrize>	<Grammy_Lifetime_Achievement_Award>
<2017_Romanian_protests>	<isCitizenOf>	<El_Salvador>
<David_O._Russell>	<wasBornIn>	<Manhattan>
<The_Haunting_(1999_film)>	<isCitizenOf>	<United_Kingdom>
<Emma_Thompson>	<actedIn>	<Angels_in_America_(miniseries)>
<Dave_Norton>	<playsFor>	<Hull_City_A.F.C.>
<Patrick_Kanyuka>	<isCitizenOf>	<Northern_Ireland>
<Harry_Warren>	<wasBornIn>	<Brooklyn>
<Michigan>	<isCitizenOf>	<Niger>
<Bobby_Olejnik>	<isCitizenOf>	<El_Salvador>
<James_Woods>	<isCitizenOf>	<Cameroon>
<Guylain_Ndumbu-Nsungu>	<isAffiliatedTo>	<Darlington_F.C.>
<Dennis_Wann>	<isAffiliatedTo>	<Chester_City_F.C.>
<Mike_Marsh_(footballer)>	<isCitizenOf>	<Israel>
<Tim_Curry>	<isCitizenOf>	<United_Kingdom>
<Toni_Silva>	<isAffiliatedTo>	<Northampton_Town_F.C.>
<Rudi_Skácel>	<isAffiliatedTo>	<Southampton_F.C.>
<Lee_J._Cobb>	<actedIn>	<The_Exorcist_(film)>
<Carole_Lombard>	<wasBornIn>	<Fort_Wayne,_Indiana>
<Ian_Stevens_(footballer)>	<isAffiliatedTo>	<Wrexham_A.F.C.>
<Martin_Woods>	<isCitizenOf>	<Belgium>
<Jason_Harris_(footballer,_born_1976)>	<isAffiliatedTo>	<Crystal_Palace_F.C.>
<The_Scorpion_King>	<isCitizenOf>	<Cape_Verde>
<Minnie_Driver>	<isCitizenOf>	<United_Kingdom>
<James_Newton_Howard>	<isCitizenOf>	<Cameroon>
<Peter_Berg>	<directed>	<Battleship_(film)>
<Georg_Wilhelm_Friedrich_Hegel>	<influences>	<Fredric_Jameson>
<India>	<hasCurrency>	<Indian_rupee>
<Nikola_Vujadinović>	<isCitizenOf>	<Greece>
<Tokyo>	<isLocatedIn>	<Japan>
<Greg_Halford>	<playsFor>	<Cardiff_City_F.C.>
<Massachusetts>	<isCitizenOf>	<Barbados>
<Jürgen_Colin>	<isCitizenOf>	<Netherlands>
<Walt_Disney_Studios_Motion_Pictures>	<isLocatedIn>	<Burbank,_California>
<Jon_Beswetherick>	<isCitizenOf>	<Greece>
<Graham_Potter>	<isCitizenOf>	<Belgium>
<Marion_County,_Florida>	<isCitizenOf>	<Cameroon>
<Emile_Hirsch>	<actedIn>	<Milk_(film)>
<Luc_Besson>	<isCitizenOf>	<Nigeria>
<Long_Turkish_War>	<isCitizenOf>	<Senegal>
<Danny_Elfman>	<wroteMusicFor>	<A_Simple_Plan_(film)>
<Tommy_Anderson_(footballer)>	<isAffiliatedTo>	<A.F.C._Bournemouth>
<John_Rowlands_(footballer)>	<isCitizenOf>	<Hungary>
<Stuart_Parker_(footballer)>	<playsFor>	<Blackburn_Rovers_F.C.>
<Jordan_Rose>	<isCitizenOf>	<Austria>
<Claude_Rains>	<isCitizenOf>	<Niger>
<Takehito_Koyasu>	<isCitizenOf>	<Japan>
<Lee_Thorpe>	<isAffiliatedTo>	<Brentford_F.C.>
<Hancock_(film)>	<isCitizenOf>	<Italy>
<Chris_Adamson>	<isAffiliatedTo>	<Stockport_County_F.C.>
<Rwanda>	<hasNeighbor>	<Democratic_Republic_of_the_Congo>
<Clyde_Wijnhard>	<isAffiliatedTo>	<FC_Groningen>
<Brian_Taylor_(footballer,_born_1937)>	<isCitizenOf>	<Australia>
<Frances_Marion>	<isCitizenOf>	<Denmark>
<Tim_Matheson>	<isCitizenOf>	<Slovenia>
<Edward_Said>	<wasBornIn>	<Jerusalem>
<Dave_Norton>	<isCitizenOf>	<Republic_of_Ireland>
<Bob_Geldof>	<isCitizenOf>	<Belgium>
<Joe_Bradshaw_(footballer)>	<isCitizenOf>	<Jamaica>
<David_Brightwell>	<isCitizenOf>	<Austria>
<Adel_Taarabt>	<isAffiliatedTo>	<RC_Lens>
<Jason_Harris_(footballer,_born_1976)>	<isCitizenOf>	<Australia>
<Equatorial_Guinea>	<isCitizenOf>	<Ukraine>
<Ben_Roberts_(footballer)>	<isCitizenOf>	<Monaco>
<George_W._Bush>	<isCitizenOf>	<Republic_of_Ireland>
<Frances_McDormand>	<hasWonPrize>	<Drama_Desk_Award>
<Jeff_Wealands>	<isCitizenOf>	<Spain>
<Gene_Stupnitsky>	<isCitizenOf>	<United_States>
<Eric_Wynalda>	<isAffiliatedTo>	<Atlanta_Silverbacks>
<Norman_Mailer>	<isCitizenOf>	<Panama>
<Frances_McDormand>	<actedIn>	<Short_Cuts_(film)>
<Normandy>	<isLocatedIn>	<Rouen>
<The_Scorpion_King>	<isLocatedIn>	<Germany>
<Gabriel_Tamaș>	<isCitizenOf>	<England>
<Simon_Webster_(footballer)>	<isAffiliatedTo>	<Sheffield_United_F.C.>
<Jeffrey_Monakana>	<isCitizenOf>	<Bulgaria>
<Geoff_Thomas_(footballer,_born_1964)>	<playsFor>	<Rochdale_A.F.C.>
<Lake_Erie>	<isCitizenOf>	<Bulgaria>
<Trevor_Aylott>	<isAffiliatedTo>	<Crystal_Palace_F.C.>
<Bridesmaids_(2011_film)>	<isCitizenOf>	<Croatia>
<Stuart_Cash>	<isCitizenOf>	<Germany>
<Ludwig_Wittgenstein>	<isCitizenOf>	<Nigeria>
<Bruno_Rodriguez>	<isAffiliatedTo>	<AS_Monaco_FC>
<Colombia>	<hasOfficialLanguage>	<Spanish_language>
<Don_Knotts>	<diedIn>	<Los_Angeles>
<Emerson_Thome>	<isAffiliatedTo>	<Derby_County_F.C.>
<Carol_Burnett>	<hasWonPrize>	<Primetime_Emmy_Award>
<Bill_Pullman>	<isCitizenOf>	<Canada>
<Ben_Gordon_(footballer,_born_1991)>	<wasBornIn>	<Bradford>
<John_Lowey_(footballer)>	<isCitizenOf>	<France>
<Parker_Posey>	<isCitizenOf>	<Panama>
<Lee_Morris_(footballer)>	<isCitizenOf>	<Bahrain>
<Robert_Louis_Stevenson>	<isCitizenOf>	<Denmark>
<Arthur_Miller>	<wasBornIn>	<Harlem>
<Lily_Tomlin>	<isCitizenOf>	<Russia>
<Scott_Davies_(footballer,_born_1988)>	<isAffiliatedTo>	<Aldershot_Town_F.C.>
<Andros_Townsend>	<isCitizenOf>	<Cyprus>
<Mike_Basham>	<playsFor>	<Grays_Athletic_F.C.>
<Danny_Graham_(footballer)>	<isAffiliatedTo>	<Blackpool_F.C.>
<Andy_Linighan>	<isAffiliatedTo>	<Arsenal_F.C.>
<Brad_Jones_(footballer)>	<playsFor>	<Sheffield_Wednesday_F.C.>
<M._Night_Shyamalan>	<isCitizenOf>	<Wales>
<Matt_Dillon>	<actedIn>	<There's_Something_About_Mary>
<Ryan_Reynolds>	<isCitizenOf>	<Chile>
<Kyle_MacLachlan>	<actedIn>	<The_Flintstones_(film)>
<Greg_Pearson>	<playsFor>	<Kidderminster_Harriers_F.C.>
<Joaquin_Phoenix>	<isCitizenOf>	<Bulgaria>
<Chicago_metropolitan_area>	<isLocatedIn>	<Evanston,_Illinois>
<Adel_Taarabt>	<isCitizenOf>	<India>
<Djamel_Abdoun>	<isAffiliatedTo>	<CS_Sedan_Ardennes>
<Fyvush_Finkel>	<isCitizenOf>	<United_States>
<Al_Green>	<isCitizenOf>	<Iran>
<Chris_Coyne>	<playsFor>	<Australia_national_soccer_team>
<Michael_Laudrup>	<isCitizenOf>	<Northern_Ireland>
<Ashley_Bayes>	<isCitizenOf>	<Croatia>
<Matthew_McConaughey>	<isCitizenOf>	<Germany>
<Matt_Stone>	<isCitizenOf>	<Greece>
<Federico_Giampaolo>	<isCitizenOf>	<Italy>
<Kinji_Fukasaku>	<diedIn>	<Tokyo>
<Joe_Walters_(footballer)>	<isCitizenOf>	<Poland>
<Iain_Turner>	<isCitizenOf>	<Croatia>
<Dele_Adebola>	<isCitizenOf>	<Puerto_Rico>
<Edmonton_Eskimos>	<isCitizenOf>	<Brazil>
<Monroe,_Louisiana>	<isCitizenOf>	<Bahrain>
<Perry_Suckling>	<isAffiliatedTo>	<SuperSport_United_F.C.>
<Brendan_Gleeson>	<actedIn>	<The_Village_(2004_film)>
<Juan_Esnáider>	<isCitizenOf>	<Puerto_Rico>
<Bas-Rhin>	<isLocatedIn>	<France>
<Ramon_Menezes>	<isCitizenOf>	<France>
<Ray_Liotta>	<actedIn>	<Smokin'_Aces>
<Tim_Carter_(footballer)>	<isCitizenOf>	<England>
<Iago_Falque>	<playsFor>	<Genoa_C.F.C.>
<Stefano_Lombardi>	<playsFor>	<A.C._Perugia_Calcio>
<Larry_Fine>	<isCitizenOf>	<Germany>
<Frances_McDormand>	<isCitizenOf>	<Nigeria>
<Jim_McCalliog>	<isAffiliatedTo>	<Southampton_F.C.>
<Lee_McEvilly>	<isAffiliatedTo>	<Cambridge_United_F.C.>
<Steve_Morgan_(footballer)>	<isCitizenOf>	<England>
<Henry_Grace>	<isCitizenOf>	<United_States>
<Carl_Sagan>	<isCitizenOf>	<Italy>
<Dean_Hammond>	<isAffiliatedTo>	<Colchester_United_F.C.>
<Chris_Withe>	<wasBornIn>	<Liverpool>
<Julia_Stiles>	<isCitizenOf>	<Italy>
<Van_Nest_Polglase>	<isCitizenOf>	<Panama>
<Elizabeth_Taylor>	<isMarriedTo>	<Richard_Burton>
<Byzantine_Empire>	<isCitizenOf>	<Kazakhstan>
<Neil_Warnock>	<isCitizenOf>	<Italy>
<Rachel_Portman>	<wroteMusicFor>	<Beloved_(film)>
<Sri_Lanka>	<isLocatedIn>	<Indian_Ocean>
<Bobby_Mimms>	<isCitizenOf>	<Netherlands>
<Dave_Hanson_(footballer)>	<isCitizenOf>	<El_Salvador>
<Sophia_Loren>	<livesIn>	<Switzerland>
<Richard_Nixon>	<isCitizenOf>	<England>
<Parlophone>	<isLocatedIn>	<United_Kingdom>
<Diego_Perrone>	<isAffiliatedTo>	<Club_Olimpia>
<Danny_Granville>	<isAffiliatedTo>	<Norwich_City_F.C.>
<Patrick_McGoohan>	<actedIn>	<The_Phantom_(1996_film)>
<Jimmy_Gauld>	<isCitizenOf>	<United_Arab_Emirates>
<Kuwait>	<isCitizenOf>	<Spain>
<Bill_Pendergast>	<isCitizenOf>	<Republic_of_Ireland>
<Weber_State_University>	<isLocatedIn>	<Utah>
<Stuart_Cash>	<playsFor>	<Wycombe_Wanderers_F.C.>
<Rocky_Mountains>	<isCitizenOf>	<Switzerland>
<Bulawayo>	<isCitizenOf>	<Russia>
<Danny_Granville>	<isCitizenOf>	<Slovenia>
<Andrew_Davies_(footballer)>	<isCitizenOf>	<Bahrain>
<Tim_Carter_(footballer)>	<isAffiliatedTo>	<Millwall_F.C.>
<Joleon_Lescott>	<isCitizenOf>	<Iran>
<Geoff_Thomas_(footballer,_born_1964)>	<isCitizenOf>	<Serbia>
<Nobel_Prize_in_Physiology_or_Medicine>	<isLocatedIn>	<Stockholm>
<Astrit_Ajdarević>	<isCitizenOf>	<Norway>
<Steve_Robinson_(Northern_Ireland_footballer)>	<isCitizenOf>	<United_States>
<Copenhagen>	<isCitizenOf>	<Austria>
<Antonio_Banderas>	<actedIn>	<Four_Rooms>
<Charles_Darwin>	<worksAt>	<University_of_Cambridge>
<Scott_Barrett_(footballer)>	<isAffiliatedTo>	<Gillingham_F.C.>
<Liam_Chilvers>	<isCitizenOf>	<Germany>
<Frank_Large>	<isCitizenOf>	<United_States>
<Emerson_(footballer,_born_1976)>	<isAffiliatedTo>	<Brazil_national_football_team>
<Éder_(Italian_footballer)>	<isAffiliatedTo>	<A.C._Cesena>
<Kumasi>	<isLocatedIn>	<Ghana>
<Gregg_Wylde>	<isAffiliatedTo>	<Celtic_F.C.>
<Darko_Bodul>	<isCitizenOf>	<Republic_of_the_Congo>
<Pamela_Adlon>	<isCitizenOf>	<Austria>
<Jack_Reynolds_(footballer,_born_1869)>	<playsFor>	<Aston_Villa_F.C.>
<Rebecca_Hall>	<isCitizenOf>	<Bulgaria>
<Liev_Schreiber>	<isCitizenOf>	<Scotland>
<EasyJet>	<isLocatedIn>	<Barcelona–El_Prat_Airport>
<Bobby_Mimms>	<isAffiliatedTo>	<Rotherham_United_F.C.>
<2010_Winter_Olympics>	<isCitizenOf>	<Iran>
<Dustin_Hoffman>	<isCitizenOf>	<Russia>
<Legend_(1985_film)>	<isLocatedIn>	<United_Kingdom>
<Baltimore–Washington_metropolitan_area>	<isCitizenOf>	<Tanzania>
<Tony_Warner>	<isCitizenOf>	<Bangladesh>
<Neil_Warnock>	<isAffiliatedTo>	<Barnsley_F.C.>
<Milwaukee_County,_Wisconsin>	<isLocatedIn>	<Milwaukee>
<Akiva_Schaffer>	<isCitizenOf>	<United_States>
<Sri_Lanka>	<isCitizenOf>	<Belgium>
<Neil_Simon>	<isCitizenOf>	<Iran>
<Kingston_upon_Hull>	<isLocatedIn>	<East_Riding_of_Yorkshire>
<Carthage>	<isCitizenOf>	<Nigeria>
<Megan_Fox>	<isCitizenOf>	<Germany>
<Scott_McDonald>	<isCitizenOf>	<Australia>
<UEFA>	<isCitizenOf>	<United_Arab_Emirates>
<Federico_Fellini>	<isCitizenOf>	<Sweden>
<Ginger_Rogers>	<wasBornIn>	<Independence,_Missouri>
<Ralph_Fiennes>	<isCitizenOf>	<Poland>
<Salma_Hayek>	<actedIn>	<Puss_in_Boots_(2011_film)>
<Alejandro_Scopelli>	<isCitizenOf>	<Norway>
<Alecko_Eskandarian>	<isCitizenOf>	<Iran>
<Edward_Zwick>	<isCitizenOf>	<Dominica>
<Harvey_Weinstein>	<isCitizenOf>	<Serbia>
<War_of_1812>	<happenedIn>	<North_America>
<Peru>	<dealsWith>	<China>
<Gerry_Anderson>	<isCitizenOf>	<England>
<Sid_Binks>	<playsFor>	<Chesterfield_F.C.>
<Djibril_Cissé>	<isAffiliatedTo>	<S.S._Lazio>
<Nick_Pope_(footballer)>	<isCitizenOf>	<Switzerland>
<Bon_Jovi>	<hasWonPrize>	<World_Music_Awards>
<Normandy>	<isCitizenOf>	<Niger>
<Mike_Nichols>	<isCitizenOf>	<Nigeria>
<Daniel_Hernández_(soccer)>	<isCitizenOf>	<England>
<Hancock_(film)>	<isLocatedIn>	<United_States>
<In_Your_House>	<isCitizenOf>	<Greece>
<Ray_Liotta>	<isCitizenOf>	<United_States>
<Mark_Hamill>	<actedIn>	<Star_Wars_Holiday_Special>
<Worthing>	<isCitizenOf>	<Brazil>
<Greg_Halford>	<isCitizenOf>	<Serbia>
<Simon_Cowell>	<isCitizenOf>	<United_States>
<Denmark>	<isCitizenOf>	<Ukraine>
<Junichi_Inamoto>	<isCitizenOf>	<El_Salvador>
<Coimbatore>	<isLocatedIn>	<Coimbatore_district>
<Clive_Barker>	<influences>	<Alan_Moore>
<Bolt_(2008_film)>	<isLocatedIn>	<United_States>
<Joe_Pasternak>	<isCitizenOf>	<Italy>
<Steven_Tyler>	<isCitizenOf>	<El_Salvador>
<Danny_Maddix>	<isAffiliatedTo>	<Grays_Athletic_F.C.>
<Cliff_Robertson>	<isCitizenOf>	<United_States>
<Mario_Bortolazzi>	<isCitizenOf>	<Northern_Ireland>
<Douglas_Adams>	<isCitizenOf>	<England>
<Rachel_Portman>	<isCitizenOf>	<Italy>
<Peter_Dougall>	<playsFor>	<Burnley_F.C.>
<Kevin_Phillips_(footballer)>	<isCitizenOf>	<Israel>
<Simon_Whaley>	<isAffiliatedTo>	<Chesterfield_F.C.>
<Peter_Meehan>	<playsFor>	<Sunderland_A.F.C.>
<Edward_Norton>	<actedIn>	<The_Illusionist_(2006_film)>
<Battle_of_France>	<happenedIn>	<Netherlands>
<Devin_Townsend>	<wasBornIn>	<New_Westminster>
<George_Carlin>	<influences>	<Whoopi_Goldberg>
<Terry_Dunfield>	<isCitizenOf>	<Nigeria>
<Alessandro_Bastrini>	<isCitizenOf>	<Switzerland>
<Eli_Wallach>	<actedIn>	<The_Holiday>
<Billy_Knott>	<isCitizenOf>	<Tanzania>
<Barry_Richardson_(English_footballer)>	<isCitizenOf>	<Israel>
<Brad_Jones_(footballer)>	<playsFor>	<Bradford_City_A.F.C.>
<Lisa_Kudrow>	<isCitizenOf>	<United_States>
<Marcus_Haber>	<isAffiliatedTo>	<Crewe_Alexandra_F.C.>
<Basil_Poledouris>	<isCitizenOf>	<Jamaica>
<Devin_Townsend>	<isCitizenOf>	<Puerto_Rico>
<John_Byrne_(footballer,_born_1961)>	<isCitizenOf>	<England>
<Maggie_Smith>	<isCitizenOf>	<China>
<The_Surreal_Life>	<isCitizenOf>	<Republic_of_Ireland>
<Ashley_Grimes_(footballer,_born_1957)>	<isAffiliatedTo>	<Luton_Town_F.C.>
<Monsef_Zerka>	<isCitizenOf>	<India>
<Keith_Curle>	<isCitizenOf>	<England>
<Jay_Emmanuel-Thomas>	<isCitizenOf>	<England>
<George_Stevens>	<isCitizenOf>	<Republic_of_the_Congo>
<Giovani_dos_Santos>	<isCitizenOf>	<Republic_of_the_Congo>
<2009_Iranian_presidential_election_protests>	<isCitizenOf>	<England>
<Paul_Rideout>	<playsFor>	<Swindon_Town_F.C.>
<Bob_Curry>	<isAffiliatedTo>	<Leeds_United_F.C.>
<Cape_May_County,_New_Jersey>	<isCitizenOf>	<Germany>
<Luftwaffe>	<isLocatedIn>	<Nazi_Germany>
<Don_Weston>	<isCitizenOf>	<Jamaica>
<Poul_Anderson>	<isCitizenOf>	<Denmark>
<Ben_Affleck>	<actedIn>	<Dogma_(film)>
<Ian_Muir>	<isCitizenOf>	<Argentina>
<Charlton_Heston>	<isCitizenOf>	<England>
<Bert_Powell>	<isCitizenOf>	<Tanzania>
<Battle_of_France>	<isCitizenOf>	<Barbados>
<Craig_Davies_(footballer)>	<isAffiliatedTo>	<Brighton_&_Hove_Albion_F.C.>
<Mike_Stowell>	<playsFor>	<Preston_North_End_F.C.>
<Nicolas_Cage>	<isCitizenOf>	<Greece>
<Eddie_Albert>	<isCitizenOf>	<Israel>
<Arthur_Sharp_(footballer)>	<isCitizenOf>	<Kazakhstan>
<Alejandro_Scopelli>	<isAffiliatedTo>	<C.F._Os_Belenenses>
<John_Hendry_(footballer)>	<isCitizenOf>	<Kazakhstan>
<Peter_Skipper>	<isAffiliatedTo>	<Scunthorpe_United_F.C.>
<Tomi_Ameobi>	<isCitizenOf>	<Niger>
<Paul_Sorvino>	<isCitizenOf>	<Japan>
<Ronnie_Wallwork>	<isAffiliatedTo>	<Manchester_United_F.C.>
<British_Columbia>	<isLocatedIn>	<Vancouver>
<The_Rainmaker_(1997_film)>	<isLocatedIn>	<Germany>
<Bradley_Thomas_(footballer)>	<isAffiliatedTo>	<Crawley_Town_F.C.>
<Lindsay_Lohan>	<actedIn>	<I_Know_Who_Killed_Me>
<Lindsay_Lohan>	<isCitizenOf>	<Canada>
<Alex_Taylor_(footballer)>	<playsFor>	<Partick_Thistle_F.C.>
<Jimmy_Fallon>	<isCitizenOf>	<Russia>
<Alan_Bennett_(footballer,_born_1981)>	<isCitizenOf>	<Bahrain>
<Kevin_McCarthy_(actor)>	<isCitizenOf>	<Brazil>
<Andy_Ferrell>	<isCitizenOf>	<United_Kingdom>
<Peter_Nicholas_(footballer)>	<isCitizenOf>	<Niger>
<Romano_Perticone>	<isCitizenOf>	<Tanzania>
<Isaiah_Washington>	<wasBornIn>	<Houston>
<Venezuela>	<isCitizenOf>	<Spain>
<CeeLo_Green>	<isCitizenOf>	<United_States>
<Arcadia,_California>	<isCitizenOf>	<Japan>
<Lee_Fowler>	<isCitizenOf>	<Bulgaria>
<University_of_Vienna>	<isCitizenOf>	<United_Kingdom>
<Bruce_Greenwood>	<isCitizenOf>	<Bangladesh>
<Carl_Dickinson>	<isCitizenOf>	<Canada>
<Darren_Ward_(footballer,_born_1978)>	<isCitizenOf>	<England>
<Craig_Allardyce>	<isCitizenOf>	<Cameroon>
<New_Brunswick>	<hasCapital>	<Fredericton>
<Geoff_Thomas_(footballer,_born_1964)>	<isAffiliatedTo>	<Crewe_Alexandra_F.C.>
<Shirley_Knight>	<isCitizenOf>	<United_States>
<Paul_Marshall_(footballer)>	<isAffiliatedTo>	<Aberdeen_F.C.>
<Mark_Yates_(footballer)>	<isCitizenOf>	<Jamaica>
<Ian_Stevens_(footballer)>	<isCitizenOf>	<Wales>
<Walon_Green>	<hasWonPrize>	<Edgar_Award>
<Philip_Yordan>	<isCitizenOf>	<Netherlands>
<Rod_Steiger>	<isCitizenOf>	<France>
<Epic_Soundtrax>	<isCitizenOf>	<India>
<Mark_Crossley>	<isCitizenOf>	<Wales>
<Josh_Wright>	<isCitizenOf>	<France>
<Chris_Powell>	<isCitizenOf>	<Russia>
<Yale_Divinity_School>	<isCitizenOf>	<Chile>
<Daniel_Inouye>	<isCitizenOf>	<Northern_Ireland>
<Thomas_Edison>	<isCitizenOf>	<Netherlands>
<Latvia>	<hasNeighbor>	<Lithuania>
<Donal_Murphy>	<isCitizenOf>	<Croatia>
<United_States>	<participatedIn>	<Operation_Serval>
<Shaq_Coulthirst>	<isCitizenOf>	<England>
<Bruno_Marioni>	<isCitizenOf>	<El_Salvador>
<Oliver_Platt>	<isCitizenOf>	<United_Kingdom>
<Mike_Basham>	<isCitizenOf>	<United_Kingdom>
<Anonymous_(film)>	<isCitizenOf>	<Wales>
<NBCUniversal>	<isCitizenOf>	<Bulgaria>
<Late_Show_(CBS_TV_series)>	<isCitizenOf>	<Jamaica>
<Cristiano_Lucarelli>	<isCitizenOf>	<Sweden>
<George_Carlin>	<isCitizenOf>	<Israel>
<Darren_Byfield>	<isAffiliatedTo>	<Bristol_City_F.C.>
<Ben_Affleck>	<isCitizenOf>	<Dominica>
<Andy_Keogh>	<isAffiliatedTo>	<Leeds_United_F.C.>
<Bob_Fosse>	<directed>	<All_That_Jazz_(film)>
<Miguel_de_Cervantes>	<isCitizenOf>	<Martinique>
<Jean-Yves_M'voto>	<isCitizenOf>	<Cameroon>
<Arkansas>	<isCitizenOf>	<Bangladesh>
<Koei_Tecmo>	<isLocatedIn>	<Kanagawa_Prefecture>
<Invercargill>	<isLocatedIn>	<South_Island>
<Peter_Ustinov>	<actedIn>	<Quo_Vadis_(1951_film)>
<Jason_Banton>	<isCitizenOf>	<Republic_of_Ireland>
<Ryan_Brunt_(footballer)>	<isAffiliatedTo>	<Plymouth_Argyle_F.C.>
<Jane_Lynch>	<isCitizenOf>	<United_Arab_Emirates>
<Myles_Weston>	<isAffiliatedTo>	<Charlton_Athletic_F.C.>
<Gary_McSheffrey>	<isAffiliatedTo>	<Birmingham_City_F.C.>
<James_Dunne>	<isCitizenOf>	<Panama>
<Anil_Kapoor>	<isCitizenOf>	<India>
<Chris_Pronger>	<isCitizenOf>	<Canada>
<Patrick_McGoohan>	<isCitizenOf>	<Belgium>
<Kevin_McCarthy_(actor)>	<graduatedFrom>	<University_of_Minnesota>
<Rita_Wilson>	<isCitizenOf>	<Bulgaria>
<Mark_Wilson_(English_footballer)>	<isCitizenOf>	<Serbia>
<Michael_Chabon>	<isCitizenOf>	<Denmark>
<Paul_Haggis>	<isCitizenOf>	<Bahrain>
<Nobel_Prize_in_Physiology_or_Medicine>	<isCitizenOf>	<Canada>
<Interscope_Records>	<isCitizenOf>	<Kazakhstan>
<Kevin_Dearden>	<playsFor>	<Brentford_F.C.>
<Al_Green>	<livesIn>	<Memphis,_Tennessee>
<Igor_Mitreski>	<isCitizenOf>	<United_Arab_Emirates>
<Salt_(2010_film)>	<isCitizenOf>	<Dominica>
<Maurizio_Iorio>	<isCitizenOf>	<Hungary>
<Anatole_Litvak>	<isCitizenOf>	<Croatia>
<Chris_Arthur>	<playsFor>	<AFC_Wimbledon>
<Wayne_Brown_(footballer,_born_August_1977)>	<isCitizenOf>	<Republic_of_Ireland>
<Sacha_Opinel>	<isAffiliatedTo>	<Leyton_Orient_F.C.>
<Harry_Belafonte>	<isCitizenOf>	<Switzerland>
<Kevin_Smith>	<isCitizenOf>	<Japan>
<René_Descartes>	<isCitizenOf>	<Sweden>
<Iago_Falque>	<isCitizenOf>	<Canada>
<Joleon_Lescott>	<wasBornIn>	<Birmingham>
<Los_Angeles_International_Airport>	<isLocatedIn>	<Greater_Los_Angeles_Area>
<Ryan_Brunt_(footballer)>	<isAffiliatedTo>	<Tranmere_Rovers_F.C.>
<Garry_Chalk>	<isCitizenOf>	<Hungary>
<Simon_Cziommer>	<isAffiliatedTo>	<FC_Utrecht>
<Mark_Farrington>	<isAffiliatedTo>	<Hereford_United_F.C.>
<Lloyd_Opara>	<isCitizenOf>	<Puerto_Rico>
<Tom_Heaton>	<isAffiliatedTo>	<Burnley_F.C.>
<Cicely_Tyson>	<isCitizenOf>	<Puerto_Rico>
<Cássio_Oliveira>	<isCitizenOf>	<Brazil>
<Sid_Binks>	<isCitizenOf>	<Monaco>
<Alan_Daley>	<isCitizenOf>	<United_Arab_Emirates>
<Yoko_Ono>	<isCitizenOf>	<Poland>
<Ronnie_Wallwork>	<isCitizenOf>	<Tanzania>
<Peter_Barnes_(footballer)>	<isAffiliatedTo>	<Hull_City_A.F.C.>
<Ardent_Records>	<isCitizenOf>	<Kazakhstan>
<Danny_Elfman>	<wroteMusicFor>	<Restless_(2011_film)>
<Paul_Kinnaird>	<isCitizenOf>	<United_Arab_Emirates>
<Drenthe>	<isCitizenOf>	<Republic_of_Ireland>
<East_Asia>	<isLocatedIn>	<Guangzhou>
<Jon_Macken>	<isAffiliatedTo>	<Preston_North_End_F.C.>
<Klaus_Badelt>	<isCitizenOf>	<Croatia>
<Jerry_Siegel>	<wasBornIn>	<Cleveland>
<James_Ingram>	<wasBornIn>	<Akron,_Ohio>
<Ibrahima_Sonko>	<isCitizenOf>	<Senegal>
<Shirley_MacLaine>	<actedIn>	<Around_the_World_in_80_Days_(1956_film)>
<Rick_Rubin>	<isCitizenOf>	<Iran>
<Heiner_Backhaus>	<isCitizenOf>	<Croatia>
<Peter_Kyle>	<isAffiliatedTo>	<Leicester_City_F.C.>
<Danube>	<isLocatedIn>	<Croatia>
<Mychael_Danna>	<isCitizenOf>	<Bulgaria>
<Marvel_Entertainment>	<owns>	<Marvel_Comics>
<Tony_Cottee>	<isAffiliatedTo>	<England_national_football_team>
<Columbia_Law_School>	<isLocatedIn>	<New_York>
<Ottoman_Empire>	<hasOfficialLanguage>	<Turkish_language>
<Inyo_County,_California>	<isLocatedIn>	<California>
<Gavin_Hoyte>	<isAffiliatedTo>	<Arsenal_F.C.>
<Dave_Metchick>	<isCitizenOf>	<Australia>
<David_Martin_(footballer,_born_1986)>	<isCitizenOf>	<Cape_Verde>
<Rafik_Djebbour>	<isCitizenOf>	<Mali>
<Kenny_Cooper>	<wasBornIn>	<Baltimore>
<Juan_Esnáider>	<isAffiliatedTo>	<Argentina_national_football_team>
<Paul_Evans_(footballer,_born_1974)>	<isAffiliatedTo>	<Swindon_Town_F.C.>
<Tajikistan>	<dealsWith>	<Switzerland>
<Amelia_(film)>	<isCitizenOf>	<Canada>
<Kevin_Spacey>	<actedIn>	<L.A._Confidential_(film)>
<Crispin_Freeman>	<isCitizenOf>	<United_States>
<Tim_Blake_Nelson>	<isCitizenOf>	<Nigeria>
<Wayne_Gray_(footballer)>	<isAffiliatedTo>	<Grays_Athletic_F.C.>
<Warner_Bros._Animation>	<isCitizenOf>	<Northern_Ireland>
<Andy_Petterson>	<isCitizenOf>	<Democratic_Republic_of_the_Congo>
<Jérôme_Leroy_(footballer)>	<isAffiliatedTo>	<Le_Havre_AC>
<Aldo_Duscher>	<isCitizenOf>	<Italy>
<Wayne_Brown_(footballer,_born_August_1977)>	<isAffiliatedTo>	<Gillingham_F.C.>
<Groucho_Marx>	<isCitizenOf>	<Puerto_Rico>
<Michael_Danzey>	<isCitizenOf>	<Italy>
<Rebecca_Hall>	<actedIn>	<Starter_for_10_(film)>
<Patrick_Vieira>	<isCitizenOf>	<Cape_Verde>
<Eugen_Bopp>	<isCitizenOf>	<Ukraine>
<Tom_Green>	<isCitizenOf>	<Jamaica>
<Peter_Kyle>	<isCitizenOf>	<Italy>
<Andrew_Hughes_(footballer,_born_1978)>	<isCitizenOf>	<India>
<Dominic_Blizzard>	<isCitizenOf>	<Kazakhstan>
<Kei_Kamara>	<isAffiliatedTo>	<Sierra_Leone_national_football_team>
<Modibo_Diakité>	<isAffiliatedTo>	<Frosinone_Calcio>
<Daniel_Kearns_(footballer)>	<isAffiliatedTo>	<West_Ham_United_F.C.>
<Ben_Roberts_(footballer)>	<isAffiliatedTo>	<Hartlepool_United_F.C.>
<Ravi_Shankar>	<wroteMusicFor>	<Gandhi_(film)>
<Paul_Allen_(footballer)>	<isCitizenOf>	<Republic_of_the_Congo>
<Paolo_Sammarco>	<isCitizenOf>	<Niger>
<Georgi_Donkov>	<isAffiliatedTo>	<VfL_Bochum>
<Michael_Cera>	<actedIn>	<Scott_Pilgrim_vs._the_World>
<Carl_Friedrich_Gauss>	<isCitizenOf>	<Netherlands>
<Federico_Fellini>	<directed>	<La_Dolce_Vita>
<Michael_Bridges>	<isAffiliatedTo>	<Sunderland_A.F.C.>
<Ludwig_Wittgenstein>	<diedIn>	<Cambridge>
<Steven_Tyler>	<hasChild>	<Liv_Tyler>
<Kelvin_Langmead>	<isAffiliatedTo>	<Preston_North_End_F.C.>
<Dominican_Republic>	<isCitizenOf>	<Barbados>
<Jimmy_Fallon>	<hasWonPrize>	<Grammy_Award>
<Uche_Ikpeazu>	<isAffiliatedTo>	<Reading_F.C.>
<Toifilou_Maoulida>	<isCitizenOf>	<Monaco>
<Grand_Teton_National_Park>	<isCitizenOf>	<Austria>
<James_Dunne>	<isAffiliatedTo>	<Wimbledon_F.C.>
<Courtney_Pitt>	<isCitizenOf>	<Bahrain>
<Richie_Foran>	<playsFor>	<Shelbourne_F.C.>
<Assassins_(film)>	<isLocatedIn>	<United_States>
<Hillsborough_County,_New_Hampshire>	<isLocatedIn>	<Nashua,_New_Hampshire>
<Bob_Ludwig>	<hasWonPrize>	<Grammy_Award>
<Kamloops>	<isLocatedIn>	<British_Columbia>
<Cássio_Oliveira>	<isAffiliatedTo>	<Club_Olimpia>
<Pat_Terry>	<isAffiliatedTo>	<Northampton_Town_F.C.>
<Wayne_Biggins>	<isAffiliatedTo>	<Stoke_City_F.C.>
<Chris_Wilder>	<isCitizenOf>	<England>
<FC_Zenit_Saint_Petersburg>	<isLocatedIn>	<Russia>
<Nintendo_World_Championships>	<isCitizenOf>	<Senegal>
<Ian_Redford>	<isCitizenOf>	<Canada>
<Guinea-Bissau>	<isCitizenOf>	<Cape_Verde>
<Albert_Holmes_(footballer,_born_1885)>	<playsFor>	<Coventry_City_F.C.>
<Mark_Nicholls>	<isCitizenOf>	<Switzerland>
<Terry_Phelan>	<isCitizenOf>	<United_Arab_Emirates>
<Jyothika>	<isCitizenOf>	<Chile>
<Liam_Chilvers>	<playsFor>	<A.F.C._Telford_United>
<Kevin_Spacey>	<isCitizenOf>	<China>
<James_Tavernier>	<isAffiliatedTo>	<Sheffield_Wednesday_F.C.>
<Billy_Manuel>	<isAffiliatedTo>	<Grays_Athletic_F.C.>
<Chicago>	<isLocatedIn>	<Chicago_metropolitan_area>
<Ben_Gordon_(footballer,_born_1991)>	<isCitizenOf>	<Scotland>
<Will_Buckley_(footballer)>	<isCitizenOf>	<India>
<James_Fox>	<isCitizenOf>	<United_Kingdom>
<Kasey_Keller>	<isCitizenOf>	<France>
<Alfred_Hitchcock>	<isCitizenOf>	<United_States>
<Luís_Leal_(footballer)>	<isCitizenOf>	<Israel>
<Gwyneth_Paltrow>	<isCitizenOf>	<Netherlands>
<Neil_Simon>	<created>	<The_Goodbye_Girl>
<Steve_Lovell_(Welsh_footballer)>	<isCitizenOf>	<Australia>
<Kevin_McLeod_(footballer)>	<isCitizenOf>	<El_Salvador>
<Shane_Lowry_(footballer)>	<isCitizenOf>	<Poland>
<Viggo_Mortensen>	<actedIn>	<Psycho_(1998_film)>
<Lee_Chapman>	<playsFor>	<Southend_United_F.C.>
<Brian_Rice_(footballer)>	<isAffiliatedTo>	<Nottingham_Forest_F.C.>
<Manny_Panther>	<isAffiliatedTo>	<Partick_Thistle_F.C.>
<Turkey>	<isCitizenOf>	<Denmark>
<Lauren_Bacall>	<actedIn>	<The_Mirror_Has_Two_Faces>
<Chris_Hackett_(footballer)>	<isAffiliatedTo>	<Heart_of_Midlothian_F.C.>
<Chris_Coyne>	<isCitizenOf>	<United_Kingdom>
<Italy>	<participatedIn>	<Lebanese_Civil_War>
<Carlos_Bocanegra>	<isCitizenOf>	<Niger>
<Anaheim,_California>	<isLocatedIn>	<California>
<Wuhan>	<isLocatedIn>	<China>
<Alex_Cisak>	<isAffiliatedTo>	<Leyton_Orient_F.C.>
<Peter_Dougall>	<isCitizenOf>	<China>
<George_Berry_(footballer)>	<isCitizenOf>	<Netherlands>
<Clinton_Morrison>	<isCitizenOf>	<England>
<Lilian_Nalis>	<playsFor>	<Plymouth_Argyle_F.C.>
<Willem_Dafoe>	<isCitizenOf>	<Israel>
<Sam_Irving>	<isCitizenOf>	<Scotland>
<Kim_Grant_(footballer)>	<isAffiliatedTo>	<Luton_Town_F.C.>
<Ryan_Burge>	<isAffiliatedTo>	<Birmingham_City_F.C.>
<K.A.A._Gent>	<isLocatedIn>	<Ghent>
<Peter_Stone>	<hasWonPrize>	<Emmy_Award>
<Rakhee_Gulzar>	<isCitizenOf>	<India>
<Warner_Bros._Animation>	<isLocatedIn>	<California>
<Ed_O'Neill>	<actedIn>	<The_Adventures_of_Ford_Fairlane>
<Alfred_Molina>	<actedIn>	<Magnolia_(film)>
<Jeffrey_Jones>	<wasBornIn>	<Buffalo,_New_York>
<Giuseppe_Greco_(footballer,_born_1983)>	<isAffiliatedTo>	<U.C._Sampdoria>
<Adam_Rooney>	<isCitizenOf>	<France>
<Kemar_Roofe>	<isCitizenOf>	<Niger>
<Bonnie_Hunt>	<isCitizenOf>	<Jamaica>
<Diane_Lane>	<actedIn>	<Casting_By>
<Simon_Callow>	<isCitizenOf>	<Argentina>
<Nicky_Shorey>	<isCitizenOf>	<Sweden>
<Uma_Thurman>	<actedIn>	<The_Avengers_(1998_film)>
<Belarus>	<isCitizenOf>	<Dominica>
<Marco_Baroni>	<isCitizenOf>	<Panama>
<Guy_Branston>	<isAffiliatedTo>	<Rotherham_United_F.C.>
<New_England_Conservatory_of_Music>	<isCitizenOf>	<Northern_Ireland>
<Van_Johnson>	<isCitizenOf>	<Hungary>
<Andy_Todd_(footballer,_born_1974)>	<isAffiliatedTo>	<Oldham_Athletic_A.F.C.>
<Jennifer_Love_Hewitt>	<isCitizenOf>	<France>
<Esteban_Cambiasso>	<isCitizenOf>	<Northern_Ireland>
<Chevy_Chase>	<isCitizenOf>	<Nigeria>
<Peter_Stone>	<isCitizenOf>	<Panama>
<Tony_Scully>	<isAffiliatedTo>	<Manchester_City_F.C.>
<Andrew_Hughes_(footballer,_born_1978)>	<isAffiliatedTo>	<Charlton_Athletic_F.C.>
<Nora_Ephron>	<created>	<Julie_&_Julia>
<John_Rowlands_(footballer)>	<isAffiliatedTo>	<Crewe_Alexandra_F.C.>
<Phil_Spector>	<wasBornIn>	<The_Bronx>
<Kingdom_of_Romania>	<participatedIn>	<Operation_Barbarossa>
<James_Horner>	<isCitizenOf>	<Senegal>
<Paul_Butler_(footballer,_born_1972)>	<isAffiliatedTo>	<Milton_Keynes_Dons_F.C.>
<Charles_Rosher>	<diedIn>	<Lisbon>
<Chris_Pronger>	<isAffiliatedTo>	<Edmonton_Oilers>
<Van_Johnson>	<actedIn>	<The_Caine_Mutiny_(film)>
<Anthony_Pulis>	<playsFor>	<Aldershot_Town_F.C.>
<Colm_Feore>	<actedIn>	<Pearl_Harbor_(film)>
<Clint_Eastwood>	<directed>	<Hereafter_(film)>
<France>	<isCitizenOf>	<Iran>
<Vera_Drake>	<isLocatedIn>	<France>
<Bas-Rhin>	<isCitizenOf>	<Spain>
<Jane_Espenson>	<isCitizenOf>	<Austria>
<Adam_Virgo>	<isAffiliatedTo>	<Bristol_Rovers_F.C.>
<Turkey>	<dealsWith>	<Iraq>
<Rosemary_Harris>	<isCitizenOf>	<England>
<Tomislav_Ivić>	<isAffiliatedTo>	<HNK_Hajduk_Split>
<Cristiano_Lucarelli>	<isAffiliatedTo>	<Italy_national_football_team>
<Baltimore–Washington_metropolitan_area>	<isLocatedIn>	<Towson,_Maryland>
<Stephen_Warnock>	<playsFor>	<Aston_Villa_F.C.>
<Julian_de_Guzman>	<isCitizenOf>	<Mali>
<Lee_Morris_(footballer)>	<isAffiliatedTo>	<Hereford_United_F.C.>
<Tommy_Tynan>	<isAffiliatedTo>	<Sheffield_Wednesday_F.C.>
<Scott_Sinclair>	<isCitizenOf>	<Scotland>
<Angela_Lansbury>	<isCitizenOf>	<Germany>
<Mel_Brooks>	<hasWonPrize>	<Grammy_Award>
<Matt_Elliott_(footballer)>	<isAffiliatedTo>	<Leicester_City_F.C.>
<Anthony_Hopkins>	<actedIn>	<Thor_(film)>
<Courtney_Pitt>	<wasBornIn>	<Paddington>
<David_Davis_(footballer)>	<isCitizenOf>	<Sweden>
<Alessandro_Rosina>	<isCitizenOf>	<Germany>
<Eddie_McGoldrick>	<isCitizenOf>	<Democratic_Republic_of_the_Congo>
<Osvaldo_Ardiles>	<isCitizenOf>	<Democratic_Republic_of_the_Congo>
<Viggo_Mortensen>	<isCitizenOf>	<Republic_of_the_Congo>
<Gavin_Mahon>	<playsFor>	<Hereford_United_F.C.>
<Arkansas>	<isLocatedIn>	<United_States>
<James_Horner>	<created>	<Willow_(film)>
<Nicolas_Cage>	<actedIn>	<Moonstruck>
<Copenhagen>	<isLocatedIn>	<Denmark>
<Los_Angeles_International_Airport>	<isCitizenOf>	<Kazakhstan>
<Wendy_Melvoin>	<isCitizenOf>	<Barbados>
<John_Roberts_(footballer,_born_1946)>	<isAffiliatedTo>	<Arsenal_F.C.>
<Duncan_McKenzie>	<isAffiliatedTo>	<Everton_F.C.>
<Quincy_Jones>	<isCitizenOf>	<Wales>
<George_Hamilton_(actor)>	<actedIn>	<The_Godfather_Part_III>
<Jonathan_Pryce>	<isCitizenOf>	<Wales>
<Edward_Shearmur>	<isCitizenOf>	<Japan>
<Andy_Petterson>	<playsFor>	<Southend_United_F.C.>
<St._Louis_Blues>	<isLocatedIn>	<St._Louis>
<Gordon_Cowans>	<isCitizenOf>	<England>
<Tony_Warner>	<playsFor>	<Wellington_Phoenix_FC>
<Burt_Lancaster>	<isCitizenOf>	<England>
<Chris_Adamson>	<isCitizenOf>	<Cyprus>
<Wayne_Biggins>	<isAffiliatedTo>	<Oxford_United_F.C.>
<Robert_Earnshaw>	<playsFor>	<Cardiff_City_F.C.>
<Etta_James>	<isCitizenOf>	<Austria>
<Tim_Matheson>	<wasBornIn>	<Glendale,_California>
<Pakistan>	<participatedIn>	<Operation_Enduring_Freedom_–_Horn_of_Africa>
<Michael_Spies>	<wasBornIn>	<Stuttgart>
<Frédéric_Piquionne>	<isCitizenOf>	<Martinique>
<Dani_Osvaldo>	<isCitizenOf>	<Cyprus>
<Grzegorz_Szamotulski>	<isCitizenOf>	<Cameroon>
<Los_Lobos>	<wroteMusicFor>	<Spy_Kids>
<63rd_Academy_Awards>	<happenedIn>	<California>
<Alan_Lee_(footballer)>	<isCitizenOf>	<Poland>
<Joe_Garner>	<isCitizenOf>	<England>
<SkyTeam>	<isCitizenOf>	<Russia>
<White_Plains,_New_York>	<isLocatedIn>	<New_York>
<Shemp_Howard>	<isCitizenOf>	<United_States>
<49th_Annual_Grammy_Awards>	<isLocatedIn>	<Los_Angeles>
<Geoff_Horsfield>	<isAffiliatedTo>	<Leicester_City_F.C.>
<War_of_1812>	<isCitizenOf>	<Northern_Ireland>
<Sam_Russell_(footballer,_born_1982)>	<isAffiliatedTo>	<Darlington_F.C.>
<Dean_Holdsworth>	<isCitizenOf>	<Panama>
<James_Woods>	<actedIn>	<Once_Upon_a_Time_in_America>
<Julian_Joachim>	<isAffiliatedTo>	<Coventry_City_F.C.>
<State_of_Mexico>	<isLocatedIn>	<Mexico>
<Chris_Isaak>	<isCitizenOf>	<United_States>
<EasyJet>	<isCitizenOf>	<United_Kingdom>
<Allan_Holdsworth>	<wasBornIn>	<Bradford>
<Arthur_Miller>	<isCitizenOf>	<Puerto_Rico>
<Syria>	<isCitizenOf>	<Wales>
<Zoran_Rajović>	<isAffiliatedTo>	<FK_Vojvodina>
<Olof_Mellberg>	<isCitizenOf>	<Iran>
<Mike_Nichols>	<isMarriedTo>	<Diane_Sawyer>
<Trevor_Aylott>	<playsFor>	<Wycombe_Wanderers_F.C.>
<Sabri_Lamouchi>	<isCitizenOf>	<Spain>
<Dominic_Blizzard>	<isAffiliatedTo>	<Plymouth_Argyle_F.C.>
<Another_Year_(film)>	<isCitizenOf>	<Slovenia>
<Percy_Whipp>	<isCitizenOf>	<Canada>
<Anthony_Hopkins>	<actedIn>	<Alexander_(2004_film)>
<Peter_Berg>	<isCitizenOf>	<Croatia>
<Winnipeg>	<isLocatedIn>	<Canada>
<Dougie_Freedman>	<isCitizenOf>	<England>
<Clint_Eastwood>	<directed>	<Million_Dollar_Baby>
<Warren_Aspinall>	<isAffiliatedTo>	<Swansea_City_A.F.C.>
<Andy_Linighan>	<isCitizenOf>	<Republic_of_the_Congo>
<Steve_Taylor_(footballer)>	<isAffiliatedTo>	<Luton_Town_F.C.>
<Dean_Morgan>	<isAffiliatedTo>	<Luton_Town_F.C.>
<Ben_Purkiss>	<wasBornIn>	<Sheffield>
<30_Days_of_Night_(film)>	<isLocatedIn>	<United_States>
<Oliver_Bozanic>	<isCitizenOf>	<Switzerland>
<Ventura,_California>	<isCitizenOf>	<Mali>
<Parker_Posey>	<actedIn>	<Best_in_Show_(film)>
<Alexander_Hleb>	<isAffiliatedTo>	<FC_Barcelona>
<Matt_Fish_(footballer)>	<isCitizenOf>	<Martinique>
<Harry_Belafonte>	<hasWonPrize>	<Jean_Hersholt_Humanitarian_Award>
<Candice_Bergen>	<isCitizenOf>	<Sweden>
<Alias_(TV_series)>	<isCitizenOf>	<Martinique>
<Simon_Webster_(footballer)>	<isCitizenOf>	<Mali>
<Willie_D._Burton>	<isCitizenOf>	<United_States>
<Abel_Xavier>	<isCitizenOf>	<Monaco>
<Ed_Asner>	<isCitizenOf>	<Croatia>
<Diane_Lane>	<isCitizenOf>	<Greece>
<Martin_Short>	<hasWonPrize>	<Tony_Award>
<Yale_Divinity_School>	<isLocatedIn>	<New_Haven,_Connecticut>
<Rick_Rubin>	<created>	<Def_Jam_Recordings>
<Liam_George>	<playsFor>	<Bury_F.C.>
<Lomana_LuaLua>	<isAffiliatedTo>	<Portsmouth_F.C.>
<James_L._Brooks>	<isCitizenOf>	<Greece>
<KV_Mechelen>	<isCitizenOf>	<France>
<Peter_Berg>	<created>	<Friday_Night_Lights_(TV_series)>
<Kuwait>	<participatedIn>	<Gulf_War>
<Raquel_Welch>	<isCitizenOf>	<United_States>
<Michael_Moriarty>	<isCitizenOf>	<Canada>
<Reg_Keating>	<isCitizenOf>	<Mali>
<Neil_Ross>	<livesIn>	<Los_Angeles>
<Austria-Hungary>	<participatedIn>	<Settling_Accounts>
<Lloyd_Opara>	<playsFor>	<Peterborough_United_F.C.>
<Bulawayo>	<isLocatedIn>	<Zimbabwe>
<Algeria>	<isLocatedIn>	<Africa>
<Patricia_Arquette>	<actedIn>	<Lost_Highway_(film)>
<Toumani_Diagouraga>	<wasBornIn>	<Paris>
<11Eleven_Project>	<isLocatedIn>	<Philippines>
<Daniel_Majstorović>	<isCitizenOf>	<Serbia>
<Artie_Lange>	<wasBornIn>	<Livingston,_New_Jersey>
<Iain_Turner>	<isAffiliatedTo>	<Everton_F.C.>
<Tangled>	<isCitizenOf>	<Panama>
<Bas_Savage>	<isCitizenOf>	<Germany>
<Meagan_Good>	<isCitizenOf>	<Democratic_Republic_of_the_Congo>
<Bob_Fosse>	<isCitizenOf>	<Puerto_Rico>
<Bondz_N'Gala>	<isAffiliatedTo>	<Yeovil_Town_F.C.>
<Julie_Walters>	<isCitizenOf>	<England>
<Craig_Allardyce>	<isAffiliatedTo>	<Blackpool_F.C.>
<Jack_Haines>	<isCitizenOf>	<Argentina>
<United_Nations_Operation_in_Somalia_II>	<isCitizenOf>	<Austria>
<Antony_Sher>	<isCitizenOf>	<Democratic_Republic_of_the_Congo>
<Bob_Ludwig>	<isCitizenOf>	<Denmark>
<Tarcisio_Burgnich>	<isCitizenOf>	<Hungary>
<Gabriel_Heinze>	<isCitizenOf>	<Panama>
<Richard_Jenkins>	<isCitizenOf>	<Scotland>
<Malaysia>	<participatedIn>	<United_Nations_Operation_in_Somalia_II>
<Matt_Jackson>	<isCitizenOf>	<Jamaica>
<James_Mason>	<actedIn>	<Julius_Caesar_(1953_film)>
<Marco_Baroni>	<isAffiliatedTo>	<Udinese_Calcio>
<Carl_Dickinson>	<playsFor>	<Watford_F.C.>
<St._Louis_Blues>	<isCitizenOf>	<Republic_of_Ireland>
<Mel_Gibson>	<isCitizenOf>	<Kazakhstan>
<Youssef_El_Akchaoui>	<isCitizenOf>	<Jamaica>
<Richard_Sylbert>	<wasBornIn>	<Brooklyn>
<Gertrude_Stein>	<diedIn>	<Neuilly-sur-Seine>
<Ballet_Shoes_(film)>	<isLocatedIn>	<United_Kingdom>
<KV_Mechelen>	<hasWonPrize>	<Nobel_Prize_in_Physiology_or_Medicine>
<Bam_Margera>	<isCitizenOf>	<Russia>
<Carmine_Gautieri>	<isCitizenOf>	<United_Arab_Emirates>
<Fergie_(singer)>	<actedIn>	<Nine_(2009_live-action_film)>
<James_Dunne>	<isAffiliatedTo>	<Nottingham_Forest_F.C.>
<Grand_Rapids,_Michigan>	<isLocatedIn>	<Michigan>
<John_Hendry_(footballer)>	<isAffiliatedTo>	<Swansea_City_A.F.C.>
<Anatole_Litvak>	<diedIn>	<Neuilly-sur-Seine>
<Howard_Shore>	<wroteMusicFor>	<The_Lord_of_the_Rings_(film_series)>
<Maggie_Smith>	<hasWonPrize>	<Tony_Award>
<John_Byrne_(footballer,_born_1939)>	<isCitizenOf>	<Austria>
<John_Seasman>	<isCitizenOf>	<Cyprus>
<Brian_Jackson_(footballer,_born_1933)>	<isCitizenOf>	<Bangladesh>
<Burt_Lancaster>	<hasWonPrize>	<Venice_Film_Festival>
<John_Barnes_(footballer)>	<isAffiliatedTo>	<Watford_F.C.>
<Salma_Hayek>	<isCitizenOf>	<Cyprus>
<Dennis_Bailey_(footballer,_born_1965)>	<isCitizenOf>	<Belgium>
<Danny_Coyne>	<isCitizenOf>	<Puerto_Rico>
<Richard_Pryor>	<influences>	<Whoopi_Goldberg>
<Joss_Labadie>	<isCitizenOf>	<England>
<Grand_Rapids,_Michigan>	<isCitizenOf>	<Mali>
<49th_Annual_Grammy_Awards>	<isCitizenOf>	<Senegal>
<Nathan_Fillion>	<actedIn>	<Super_(2010_American_film)>
<Justin_Chambers>	<wasBornIn>	<Springfield,_Ohio>
<Kansas_City,_Missouri>	<isCitizenOf>	<Puerto_Rico>
<Sanmi_Odelusi>	<isCitizenOf>	<Cyprus>
<Allan_Nielsen>	<isCitizenOf>	<England>
<Brian_Jackson_(footballer,_born_1933)>	<isAffiliatedTo>	<Burton_Albion_F.C.>
<Billy_Hendry>	<isAffiliatedTo>	<Kidderminster_Harriers_F.C.>
<Sam_Togwell>	<isAffiliatedTo>	<Barnet_F.C.>
<Jeffrey_Jones>	<isCitizenOf>	<Slovenia>
<W._E._B._Du_Bois>	<isCitizenOf>	<Iran>
<Chris_Crowe>	<wasBornIn>	<Newcastle_upon_Tyne>
<FC_Basel>	<isLocatedIn>	<Basel>
<Martin_Woods>	<isAffiliatedTo>	<Doncaster_Rovers_F.C.>
<Raïs_M'Bolhi>	<wasBornIn>	<Paris>
<Jonson_Clarke-Harris>	<isAffiliatedTo>	<Peterborough_United_F.C.>
<Invercargill>	<isCitizenOf>	<Bahrain>
<Matthew_Barnes-Homer>	<playsFor>	<Kidderminster_Harriers_F.C.>
<Lewis_Guy>	<isCitizenOf>	<Canada>
<Danny_Sonner>	<isCitizenOf>	<Northern_Ireland>
<Clint_Hill_(footballer)>	<playsFor>	<Queens_Park_Rangers_F.C.>
<Joe_Johnson_(footballer,_born_1911)>	<wasBornIn>	<Grimsby>
<Jon_Stone>	<isCitizenOf>	<United_States>
<Peter_Skipper>	<isCitizenOf>	<France>
<Jon_Beswetherick>	<isAffiliatedTo>	<Kidderminster_Harriers_F.C.>
<Jimmy_Spencer_(footballer)>	<isAffiliatedTo>	<Cambridge_United_F.C.>
<Italy>	<isCitizenOf>	<France>
<Yale_School_of_Medicine>	<isCitizenOf>	<Italy>
<Pelé_(footballer,_born_1978)>	<isCitizenOf>	<Cape_Verde>
<Gregg_Wylde>	<isCitizenOf>	<Russia>
<Legend_(1985_film)>	<isCitizenOf>	<Sweden>
<United_Kingdom>	<isCitizenOf>	<Bahrain>
<Mark_Wilson_(English_footballer)>	<playsFor>	<Walsall_F.C.>
<Tim_Sherwood>	<isCitizenOf>	<Poland>
<Arthur_Beadsworth>	<playsFor>	<Blackburn_Rovers_F.C.>
<2013–14_chikungunya_outbreak>	<isCitizenOf>	<Cameroon>
<Roberto_Baronio>	<isCitizenOf>	<France>
<Nintendo_World_Championships>	<isLocatedIn>	<Cleveland>
<Edmund_Husserl>	<graduatedFrom>	<Leipzig_University>
<Michael_Connelly>	<isCitizenOf>	<United_States>
<Billy_Knott>	<isAffiliatedTo>	<Port_Vale_F.C.>
<Richard_O'Donnell>	<isAffiliatedTo>	<Chesterfield_F.C.>
<Sally_Field>	<isCitizenOf>	<Ukraine>
<Amari_Morgan-Smith>	<isCitizenOf>	<Northern_Ireland>
<Intel>	<isCitizenOf>	<Poland>
<Graham_Potter>	<playsFor>	<West_Bromwich_Albion_F.C.>
<Meryl_Streep>	<isCitizenOf>	<Scotland>
<Tommy_Anderson_(footballer)>	<isCitizenOf>	<Serbia>
<Trevor_Ross>	<isCitizenOf>	<Barbados>
<Brad_Friedel>	<isCitizenOf>	<Slovenia>
<Isaiah_Washington>	<isCitizenOf>	<Bangladesh>
<Jon_Dahl_Tomasson>	<isCitizenOf>	<Sweden>
<Simeon_Hodson>	<playsFor>	<Altrincham_F.C.>
<Julian_Joachim>	<isCitizenOf>	<Bangladesh>
<César_Prates>	<isCitizenOf>	<Cameroon>
<Steve_Torpey_(footballer,_born_1970)>	<isAffiliatedTo>	<Scunthorpe_United_F.C.>
<Gary_Mulligan>	<isAffiliatedTo>	<Gillingham_F.C.>
<Sofia_Coppola>	<hasWonPrize>	<Independent_Spirit_Award_for_Best_Director>
<Jonatan_Johansson_(footballer)>	<isAffiliatedTo>	<Norwich_City_F.C.>
<Bob_Curry>	<isAffiliatedTo>	<Colchester_United_F.C.>
<Ryan_Brunt_(footballer)>	<isCitizenOf>	<Panama>
<Alex_Graves>	<isCitizenOf>	<Wales>
<Albano_Bizzarri>	<isCitizenOf>	<Republic_of_the_Congo>
<Jamar_Loza>	<isCitizenOf>	<Jamaica>
<Ventura,_California>	<isLocatedIn>	<United_States>
<Giovanni_Sio>	<isCitizenOf>	<Martinique>
<Blackpool>	<isLocatedIn>	<North_West_England>
<Bertie_Brayley>	<isAffiliatedTo>	<Swindon_Town_F.C.>
<Vanderlei_Luxemburgo>	<isAffiliatedTo>	<Real_Madrid_C.F.>
<Pasquale_Foggia>	<isCitizenOf>	<Netherlands>
<Alan_Silvestri>	<wroteMusicFor>	<Back_to_the_Future_Part_III>
<Richard_Key>	<isCitizenOf>	<Brazil>
<Peter_Tork>	<isCitizenOf>	<Norway>
<Damon_Lindelof>	<wasBornIn>	<Teaneck,_New_Jersey>
<Greater_Sudbury>	<isLocatedIn>	<Ontario>
<Epsom>	<isLocatedIn>	<Surrey>
<Aaron_Shure>	<isCitizenOf>	<China>
<Marco_Zanchi>	<isCitizenOf>	<Italy>
<Terrence_McNally>	<isCitizenOf>	<Austria>
<Greenwood,_Mississippi>	<isCitizenOf>	<Monaco>
<Serbia>	<dealsWith>	<Italy>
<Jackie_Shroff>	<isCitizenOf>	<Kazakhstan>
<Craig_McAllister>	<isAffiliatedTo>	<Luton_Town_F.C.>
<David_Boreanaz>	<isCitizenOf>	<Slovenia>
<James_Rebhorn>	<actedIn>	<The_Adventures_of_Pluto_Nash>
<Tom_Cowan>	<isAffiliatedTo>	<Huddersfield_Town_A.F.C.>
<XXX_(2002_film)>	<isLocatedIn>	<United_States>
<Jane_Espenson>	<wasBornIn>	<Ames,_Iowa>
<Daniel_Inouye>	<wasBornIn>	<Honolulu>
<George_Carlin>	<wasBornIn>	<New_York_City>
<Arthur_Phoenix>	<isCitizenOf>	<Slovenia>
<Craig_Armstrong_(composer)>	<isCitizenOf>	<United_Kingdom>
<Pamela_Adlon>	<hasWonPrize>	<Primetime_Emmy_Award>
<Noel_Whelan_(footballer)>	<playsFor>	<Harrogate_Town_F.C.>
<Uche_Ikpeazu>	<isCitizenOf>	<Northern_Ireland>
<Harry_Warren>	<isCitizenOf>	<Austria>
<Rajinikanth>	<isCitizenOf>	<Tanzania>
<Matthew_Barnes-Homer>	<isCitizenOf>	<Bangladesh>
<Ben_Hamer>	<isAffiliatedTo>	<Bristol_City_F.C.>
<Sierra_Entertainment>	<isLocatedIn>	<Fresno,_California>
<Éder_(Italian_footballer)>	<isCitizenOf>	<United_States>
<Lake_Erie>	<isLocatedIn>	<Erie,_Pennsylvania>
<Nick_Pope_(footballer)>	<isAffiliatedTo>	<Welling_United_F.C.>
<Armand_Assante>	<isCitizenOf>	<Bulgaria>
<Massachusetts>	<isLocatedIn>	<United_States>
<Laura_Carmichael>	<isCitizenOf>	<England>
<Andrew_Stanton>	<isCitizenOf>	<Dominica>
<Eduardo_Hurtado>	<isCitizenOf>	<Argentina>
<Van_Nuys>	<isLocatedIn>	<California>
<Martin_Short>	<isCitizenOf>	<El_Salvador>
<Anaheim,_California>	<isCitizenOf>	<Monaco>
<Sangamon_County,_Illinois>	<isLocatedIn>	<Illinois>
<Emory_University>	<isCitizenOf>	<Iran>
<George_Lucas>	<isCitizenOf>	<Sweden>
<Barry_Robson>	<isAffiliatedTo>	<Middlesbrough_F.C.>
<Adrian_Littlejohn>	<isAffiliatedTo>	<Walsall_F.C.>
<Epsom>	<isCitizenOf>	<Switzerland>
<Elizabeth_Banks>	<isCitizenOf>	<Greece>
<Abel_Xavier>	<playsFor>	<Everton_F.C.>
<Mark_Wilson_(English_footballer)>	<playsFor>	<Tranmere_Rovers_F.C.>
<Armenia>	<dealsWith>	<Turkey>
<Matt_McNeil>	<isCitizenOf>	<Sweden>
<46th_Academy_Awards>	<happenedIn>	<Dorothy_Chandler_Pavilion>
<John_Ford>	<isCitizenOf>	<Switzerland>
<Greater_Sudbury>	<isCitizenOf>	<Austria>
<Pennine_Alps>	<isLocatedIn>	<Piedmont>
<Noel_Whelan_(footballer)>	<isCitizenOf>	<Northern_Ireland>
<Rafik_Djebbour>	<isAffiliatedTo>	<Panionios_F.C.>
<Simon_Colosimo>	<playsFor>	<Manchester_City_F.C.>
<Simon_Gillett>	<isCitizenOf>	<Cameroon>
<Junichi_Inamoto>	<isAffiliatedTo>	<Eintracht_Frankfurt>
<Sid_Jones>	<isAffiliatedTo>	<Swansea_City_A.F.C.>
<Sean_Astin>	<isCitizenOf>	<Cameroon>
<Josh_Homme>	<isCitizenOf>	<United_States>
<Hugh_Laurie>	<isCitizenOf>	<China>
<Shefki_Kuqi>	<playsFor>	<Oldham_Athletic_A.F.C.>
<Georgi_Donkov>	<isCitizenOf>	<Australia>
<Alexander_Payne>	<isCitizenOf>	<United_Arab_Emirates>
<Steven_Zaillian>	<isCitizenOf>	<Greece>
<Santa_Rosa,_California>	<isCitizenOf>	<Australia>
<Eritrea>	<isCitizenOf>	<Wales>
<Walt_Disney>	<isCitizenOf>	<Austria>
<Long_Turkish_War>	<happenedIn>	<Czech_Republic>
<The_Golden_Compass_(film)>	<isCitizenOf>	<Bangladesh>
<Jamie_Waite>	<isCitizenOf>	<United_Kingdom>
<Mich>	<isLocatedIn>	<Iran>
<Pontifical_Gregorian_University>	<isCitizenOf>	<Wales>
<Bertie_Brayley>	<isCitizenOf>	<Belgium>
<Henry_James>	<wasBornIn>	<United_States>
<Mike_Oldfield>	<isCitizenOf>	<England>
<Mickaël_Antoine-Curier>	<isCitizenOf>	<United_States>
<Danny_Maddix>	<isCitizenOf>	<Niger>
<New_Bedford,_Massachusetts>	<isLocatedIn>	<Massachusetts>
<Jon_Shaw>	<isCitizenOf>	<Norway>
<Alex_Borstein>	<isCitizenOf>	<United_States>
<Himesh_Reshammiya>	<wasBornIn>	<Mumbai>
<Christian_Hanson_(footballer)>	<wasBornIn>	<Middlesbrough>
<Carlos_Tevez>	<isCitizenOf>	<China>
<Garry_Chalk>	<livesIn>	<British_Columbia>
<Graham_Greene_(actor)>	<hasWonPrize>	<Grammy_Award>
<Clint_Hill_(footballer)>	<isCitizenOf>	<Australia>
<Michel_Kuipers>	<wasBornIn>	<Amsterdam>
<Shane_Lowry_(footballer)>	<wasBornIn>	<Perth>
<Craig_Davies_(footballer)>	<isCitizenOf>	<Argentina>
<Ed_Helms>	<isCitizenOf>	<Democratic_Republic_of_the_Congo>
<Paul_Gascoigne>	<isCitizenOf>	<Senegal>
<Van_Nest_Polglase>	<diedIn>	<Los_Angeles>
<Adam_Rooney>	<isAffiliatedTo>	<Bury_F.C.>
<Johann_Wolfgang_von_Goethe>	<influences>	<Georg_Wilhelm_Friedrich_Hegel>
<Jimmy_Spencer_(footballer)>	<isCitizenOf>	<Wales>
<James_Blunt>	<isCitizenOf>	<Iran>
<Ernie_Watkins_(footballer,_born_1898)>	<isCitizenOf>	<Kazakhstan>
<Gavin_Mahon>	<isCitizenOf>	<Dominica>
<Gary_Mulligan>	<isCitizenOf>	<Barbados>
<Anne_Bancroft>	<isCitizenOf>	<Barbados>
<Mark_Bowen_(footballer)>	<isAffiliatedTo>	<Stoke_City_F.C.>
<Howard_Gordon>	<hasWonPrize>	<Primetime_Emmy_Award_for_Outstanding_Writing_for_a_Drama_Series>
<Jason_Flemyng>	<actedIn>	<From_Hell_(film)>
<Judi_Dench>	<actedIn>	<My_Week_with_Marilyn>
<Vancouver_Canucks>	<isCitizenOf>	<Poland>
<Tony_Lormor>	<playsFor>	<Shrewsbury_Town_F.C.>
<Karim_Rekik>	<isCitizenOf>	<Argentina>
<Reece_Styche>	<playsFor>	<Macclesfield_Town_F.C.>
<Darko_Bodul>	<isAffiliatedTo>	<SC_Heerenveen>
<Sophia_Loren>	<isCitizenOf>	<Norway>
<Wayne_Cegielski>	<isCitizenOf>	<Democratic_Republic_of_the_Congo>
<Darren_Potter>	<isCitizenOf>	<United_Kingdom>
<John_Cairns_(footballer)>	<isCitizenOf>	<Spain>
<M._Night_Shyamalan>	<directed>	<The_Last_Airbender>
<Alias_(TV_series)>	<isLocatedIn>	<United_States>
<Vancouver_Canucks>	<isLocatedIn>	<British_Columbia>
<James_Remar>	<isCitizenOf>	<Russia>
<General_Electric>	<isLocatedIn>	<Fairfield,_Connecticut>
<Craig_Ireland>	<isCitizenOf>	<Cameroon>
<John_Michael_Higgins>	<isCitizenOf>	<Belgium>
<Richard_Walker_(footballer,_born_1977)>	<isCitizenOf>	<Norway>
<Kansas_City,_Missouri>	<isLocatedIn>	<Jackson_County,_Missouri>
<Jajá>	<isAffiliatedTo>	<Clube_de_Regatas_do_Flamengo>
<Dean_Morgan>	<isCitizenOf>	<Denmark>
<Elizabeth_McGovern>	<isCitizenOf>	<Democratic_Republic_of_the_Congo>
<Jim_Goodwin>	<isCitizenOf>	<Panama>
<Carlos_Ruiz_(Guatemalan_footballer)>	<isCitizenOf>	<Nigeria>
<Patrick_Suffo>	<isAffiliatedTo>	<FC_Barcelona_B>
<Kenya>	<isCitizenOf>	<Tanzania>
<Bill_Pendergast>	<playsFor>	<Crewe_Alexandra_F.C.>
<Libya>	<isCitizenOf>	<Kazakhstan>
<Youssef_El_Akchaoui>	<isAffiliatedTo>	<Morocco_national_football_team>
<Karan_Johar>	<isCitizenOf>	<Norway>
<Peter_Swan_(footballer,_born_1966)>	<isAffiliatedTo>	<Plymouth_Argyle_F.C.>
<Alan_Lee_(footballer)>	<isAffiliatedTo>	<Rotherham_United_F.C.>
<United_States>	<participatedIn>	<Apache_Wars>
<Laurent_Robert>	<isAffiliatedTo>	<Levante_UD>
<Tommy_Tynan>	<isCitizenOf>	<Canada>
<Leonard_Nimoy>	<actedIn>	<Star_Trek_(film)>
<Colombia>	<isCitizenOf>	<Brazil>
<Brad_Jones_(footballer)>	<isCitizenOf>	<Nigeria>
<Frank_Worthington>	<isAffiliatedTo>	<Leeds_United_F.C.>
<Frederick_Mearns>	<isCitizenOf>	<Puerto_Rico>
<Jane_Fonda>	<isCitizenOf>	<Netherlands>
<Phil_Stant>	<playsFor>	<Dover_Athletic_F.C.>
<2017_Romanian_protests>	<happenedIn>	<Cologne>
<Adil_Ramzi>	<playsFor>	<AZ_Alkmaar>
<Des_Lyttle>	<isAffiliatedTo>	<West_Bromwich_Albion_F.C.>
<Columbia_University_Graduate_School_of_Journalism>	<isCitizenOf>	<Japan>
<Adam_Virgo>	<isCitizenOf>	<Brazil>
<Gary_Shelton>	<isAffiliatedTo>	<Walsall_F.C.>
<Cristian_Montaño>	<isAffiliatedTo>	<Oldham_Athletic_A.F.C.>
<Carlos_Bocanegra>	<isAffiliatedTo>	<Rangers_F.C.>
<Peter_Meehan>	<isCitizenOf>	<Dominica>
<Andy_Oakes_(footballer)>	<isCitizenOf>	<England>
<Bradley_Thomas_(footballer)>	<isCitizenOf>	<England>
<Stewart_Littlewood>	<isAffiliatedTo>	<Oldham_Athletic_A.F.C.>
<Waheeda_Rehman>	<isCitizenOf>	<India>
<Carlton_Cuse>	<wasBornIn>	<Mexico_City>
<11Eleven_Project>	<isLocatedIn>	<United_States>
<Steve_Anthrobus>	<isCitizenOf>	<Cyprus>
<Otto_Pfister>	<isCitizenOf>	<Senegal>
<Max_Casella>	<isCitizenOf>	<United_States>
<Carole_Lombard>	<isMarriedTo>	<Clark_Gable>
<Daniel_Nardiello>	<isAffiliatedTo>	<Bury_F.C.>
<Dimitar_Makriev>	<isCitizenOf>	<Poland>
<Ben_Wilkinson>	<isCitizenOf>	<Northern_Ireland>
<Dave_Martin_(footballer,_born_1963)>	<isAffiliatedTo>	<Leyton_Orient_F.C.>
<Wikimedia_Foundation>	<isCitizenOf>	<Ukraine>
<Youssouf_Hersi>	<isCitizenOf>	<Bulgaria>
<Aaron_Brown_(footballer,_born_1980)>	<isCitizenOf>	<Slovenia>
<Jason_Lee_(footballer)>	<isCitizenOf>	<Chile>
<Julian_Alsop>	<playsFor>	<Northampton_Town_F.C.>
<Toho>	<isLocatedIn>	<Chiyoda,_Tokyo>
<Kelly_Preston>	<isCitizenOf>	<Northern_Ireland>
<Frederick_Mearns>	<isAffiliatedTo>	<Grays_Athletic_F.C.>
<Mike_Marsh_(footballer)>	<isAffiliatedTo>	<Galatasaray_S.K._(football)>
<Steve_Zahn>	<isCitizenOf>	<Kazakhstan>
<Grand_Teton_National_Park>	<isLocatedIn>	<United_States>
<Mel_Brooks>	<isCitizenOf>	<Italy>
<Aruna_Irani>	<wasBornIn>	<Mumbai>
<Edmonton_Eskimos>	<isLocatedIn>	<Edmonton>
<Mario_Bortolazzi>	<isAffiliatedTo>	<Hellas_Verona_F.C.>
<Mark_Yeates>	<isCitizenOf>	<Republic_of_Ireland>
<Johann_Wolfgang_von_Goethe>	<isCitizenOf>	<Ukraine>
<Columbia_University_Graduate_School_of_Journalism>	<isLocatedIn>	<Manhattan>
<Alan_Silvestri>	<isCitizenOf>	<Barbados>
<Carol_Burnett>	<isCitizenOf>	<United_States>
<War_of_the_First_Coalition>	<isCitizenOf>	<Republic_of_the_Congo>
<Columbia,_South_Carolina>	<isCitizenOf>	<Brazil>
<O'Neill_Donaldson>	<isAffiliatedTo>	<Mansfield_Town_F.C.>
<Jake_Edwards_(footballer,_born_1976)>	<isCitizenOf>	<Sweden>
<Paul_Evans_(footballer,_born_1974)>	<isCitizenOf>	<Democratic_Republic_of_the_Congo>
<Don_Johnson>	<isCitizenOf>	<England>
<Ferenc_Puskás>	<isCitizenOf>	<Greece>
<Wikimedia_Foundation>	<isLocatedIn>	<Los_Angeles>
<White_Plains,_New_York>	<isCitizenOf>	<Ukraine>
<Riccardo_Meggiorini>	<isCitizenOf>	<Tanzania>
<Loïc_Rémy>	<isCitizenOf>	<Poland>
<Worcester_County,_Massachusetts>	<isCitizenOf>	<Niger>
<Donna_Summer>	<isCitizenOf>	<Democratic_Republic_of_the_Congo>
<Meryl_Streep>	<actedIn>	<Fantastic_Mr._Fox_(film)>
<Steve_Guinan>	<isAffiliatedTo>	<Shrewsbury_Town_F.C.>
<Nikodimos_Papavasiliou>	<isCitizenOf>	<Dominica>
<New_Zealand>	<dealsWith>	<Germany>
<Geoff_Horsfield>	<isCitizenOf>	<Israel>
<Denver_Nuggets>	<isLocatedIn>	<Denver>
<Nathan_Lane>	<isCitizenOf>	<United_States>
<Andy_Gray_(footballer,_born_1964)>	<isCitizenOf>	<Republic_of_the_Congo>
<Alexandre_Desplat>	<isCitizenOf>	<Greece>
<Eric_Gerets>	<isCitizenOf>	<United_Arab_Emirates>
<Carlton_Cuse>	<isCitizenOf>	<Chile>
<Gainesville,_Florida>	<isCitizenOf>	<United_States>
<Jimmy_Miller_(footballer)>	<isCitizenOf>	<China>
<Mickaël_Antoine-Curier>	<playsFor>	<Oldham_Athletic_A.F.C.>
<Allan_Holdsworth>	<isCitizenOf>	<Ukraine>
<Claude_Davis>	<isAffiliatedTo>	<Derby_County_F.C.>
<Brent_Sancho>	<isAffiliatedTo>	<Portland_Timbers>
<Sydney_Pollack>	<directed>	<The_Firm_(1993_film)>
<June_Carter_Cash>	<isCitizenOf>	<United_States>
<Madan_Puri>	<isCitizenOf>	<India>
<Arthur_Sharp_(footballer)>	<playsFor>	<Reading_F.C.>
<Jason_Kidd>	<isAffiliatedTo>	<Phoenix_Suns>
<Scott_Canham>	<isAffiliatedTo>	<West_Ham_United_F.C.>
<Bruno_Zuculini>	<isCitizenOf>	<England>
<Keith_Rowland>	<isAffiliatedTo>	<Coventry_City_F.C.>
<Howard_Shore>	<isCitizenOf>	<Scotland>
<Dennis_Wann>	<isCitizenOf>	<Panama>
<Santa_Monica,_California>	<isLocatedIn>	<Los_Angeles_County,_California>
<Fraizer_Campbell>	<isAffiliatedTo>	<Hull_City_A.F.C.>
<William_Thomson,_1st_Baron_Kelvin>	<isCitizenOf>	<England>
<Andy_Kennedy_(footballer,_born_1964)>	<isAffiliatedTo>	<Sheffield_United_F.C.>
<Cape_May_County,_New_Jersey>	<isLocatedIn>	<New_Jersey>
<Michael_Giacchino>	<isCitizenOf>	<United_States>
<Phil_Marsh>	<isCitizenOf>	<Greece>
<Craig_Ireland>	<playsFor>	<Notts_County_F.C.>
<Chris_Hackett_(footballer)>	<isCitizenOf>	<Panama>
<George_W._Bush>	<wasBornIn>	<New_Haven,_Connecticut>
<Carter_Burwell>	<isCitizenOf>	<El_Salvador>
<Pasquale_Foggia>	<playsFor>	<A.C._Milan>
<Dorothy_Fields>	<isCitizenOf>	<Switzerland>
<Alphonse_Tchami>	<isAffiliatedTo>	<Odense_Boldklub>
<Saša_Ilić_(footballer,_born_1972)>	<isAffiliatedTo>	<Portsmouth_F.C.>
<Peter_Ustinov>	<isCitizenOf>	<India>
<Drenthe>	<isLocatedIn>	<Netherlands>
<Paolo_Sammarco>	<isAffiliatedTo>	<A.C._ChievoVerona>
<Matuzalém>	<isCitizenOf>	<Barbados>
<Rod_Steiger>	<actedIn>	<In_the_Heat_of_the_Night_(film)>
<Gaston_Taument>	<isCitizenOf>	<Austria>
<Kezie_Ibe>	<isCitizenOf>	<England>
<Dani_Osvaldo>	<playsFor>	<Boca_Juniors>
<Paul_Sorvino>	<actedIn>	<Bulworth>
<Harry_Gregson-Williams>	<wroteMusicFor>	<Kingdom_of_Heaven_(film)>
<David_McCracken>	<isAffiliatedTo>	<Dundee_United_F.C.>
<Jeff_Whitley>	<playsFor>	<Northwich_Victoria_F.C.>
<Walon_Green>	<isCitizenOf>	<Belgium>
<József_Viola>	<isAffiliatedTo>	<A.C._Milan>
<Warren_Feeney>	<isAffiliatedTo>	<Sheffield_Wednesday_F.C.>
<David_Martin_(footballer,_born_1986)>	<isAffiliatedTo>	<Wimbledon_F.C.>
<Electric_Daisy_Carnival>	<isLocatedIn>	<Las_Vegas>
<Larry_Niven>	<isCitizenOf>	<United_States>
<Transylvania>	<isCitizenOf>	<Bulgaria>
<József_Viola>	<isCitizenOf>	<Martinique>
<Tommy_Chong>	<isCitizenOf>	<Serbia>
<Matt_Fish_(footballer)>	<isAffiliatedTo>	<Crystal_Palace_F.C.>
<Steve_Lovell_(Welsh_footballer)>	<isAffiliatedTo>	<Ebbsfleet_United_F.C.>
<Dimitris_Papadopoulos>	<isCitizenOf>	<Croatia>
<Amari_Morgan-Smith>	<wasBornIn>	<Wolverhampton>
<Scott_Canham>	<isCitizenOf>	<Wales>
<Neil_Ross>	<isCitizenOf>	<Tanzania>
<Sylvester_Stallone>	<actedIn>	<Oscar_(1991_film)>
<Steven_Zaillian>	<hasWonPrize>	<Academy_Award_for_Best_Adapted_Screenplay>
<Guy_Branston>	<playsFor>	<Lincoln_City_F.C.>
<Graham_Potter>	<wasBornIn>	<Solihull>
<Rosario_Dawson>	<isCitizenOf>	<Australia>
<Philippe_Senderos>	<isCitizenOf>	<Greece>
<Alan_Fettis>	<isCitizenOf>	<Tanzania>
<Heiner_Backhaus>	<playsFor>	<Olympiakos_Nicosia>
<Oleh_Koshelyuk>	<isCitizenOf>	<Ukraine>
<Pennine_Alps>	<isCitizenOf>	<Argentina>
<Rajasthan>	<isLocatedIn>	<Jaipur>
<Libya>	<hasNeighbor>	<Tunisia>
<The_Surreal_Life>	<isLocatedIn>	<United_States>
<General_Dynamics>	<isCitizenOf>	<Austria>
<Jon_Parkin>	<isCitizenOf>	<Germany>
<West_Java>	<isCitizenOf>	<Ukraine>
<Osvaldo_Ardiles>	<isAffiliatedTo>	<GNK_Dinamo_Zagreb>
<George_Orwell>	<isCitizenOf>	<Spain>
<Donna_Summer>	<hasWonPrize>	<Grammy_Award>
<Clive_Barker>	<isCitizenOf>	<France>
<Roberto_Baronio>	<isAffiliatedTo>	<Udinese_Calcio>
<Simon_Heslop>	<isAffiliatedTo>	<Northwich_Victoria_F.C.>
<Mark_Farrington>	<isCitizenOf>	<India>
<Nikola_Tesla>	<isCitizenOf>	<Hungary>
<Brian_Birch>	<isCitizenOf>	<Nigeria>
<Simon_Heslop>	<isCitizenOf>	<Mali>
<Adil_Ramzi>	<isCitizenOf>	<Northern_Ireland>
<Robert_F._Kennedy>	<graduatedFrom>	<Harvard_University>
<Michel_Kuipers>	<isCitizenOf>	<England>
<Stark_County,_Ohio>	<isCitizenOf>	<Bangladesh>
<Chris_Palmer_(footballer)>	<isAffiliatedTo>	<Tamworth_F.C.>
<John_Moncur>	<isAffiliatedTo>	<West_Ham_United_F.C.>
<Gavin_Ward_(footballer)>	<isCitizenOf>	<Serbia>
<Edward_Said>	<isCitizenOf>	<Mali>
<Shohreh_Aghdashloo>	<isCitizenOf>	<Denmark>
<Jermaine_Pennant>	<isCitizenOf>	<Spain>
<Robert_Loggia>	<isCitizenOf>	<Germany>
<Davide_Dionigi>	<isCitizenOf>	<Bulgaria>
<Daniel_Jones_(footballer)>	<isCitizenOf>	<France>
<Jajá>	<isCitizenOf>	<England>
<Ben_Smith_(footballer,_born_1978)>	<isCitizenOf>	<Belgium>
<John_Ford>	<actedIn>	<The_Quiet_Man>
<Lee_Peltier>	<wasBornIn>	<Liverpool>
<Klaus_Badelt>	<wroteMusicFor>	<TMNT_(film)>
<Norman_Mailer>	<actedIn>	<When_We_Were_Kings>
<Intel>	<isLocatedIn>	<California>
<Grégory_Tadé>	<isAffiliatedTo>	<Forfar_Athletic_F.C.>
<Colm_Feore>	<isCitizenOf>	<Poland>
<Lucy_Liu>	<isCitizenOf>	<United_States>
<Wehrmacht>	<isCitizenOf>	<Senegal>
<United_Kingdom>	<participatedIn>	<Operation_Enduring_Freedom>
<Peter_Beadle>	<isCitizenOf>	<Monaco>
<Alex_Rodman>	<isAffiliatedTo>	<Notts_County_F.C.>
<Scott_Brown_(footballer,_born_April_1985)>	<isAffiliatedTo>	<Eastleigh_F.C.>
<Frank_Soo>	<isCitizenOf>	<Italy>
<Brian_Austin_Green>	<isCitizenOf>	<United_States>
<Jim_McDonagh>	<isCitizenOf>	<Hungary>
<Josh_Low>	<isCitizenOf>	<Wales>
<John_Guidetti>	<isCitizenOf>	<Panama>
<Novak_Djokovic>	<livesIn>	<Monaco>
<Ray_Haddington>	<isAffiliatedTo>	<A.F.C._Bournemouth>
<Kevin_Austin>	<isCitizenOf>	<Iran>
<Jae_Martin>	<isAffiliatedTo>	<Lincoln_City_F.C.>
<Toni_Silva>	<isCitizenOf>	<Panama>
<Phil_Spector>	<isCitizenOf>	<Cyprus>
<War_of_the_Spanish_Succession>	<isCitizenOf>	<Barbados>
<George_Stevens>	<directed>	<A_Place_in_the_Sun_(film)>
<Krisztián_Németh>	<isCitizenOf>	<Hungary>
<Boise_State_University>	<isCitizenOf>	<Serbia>
<The_Walt_Disney_Company>	<owns>	<Disney_Interactive_Studios>
<Terry_Phelan>	<wasBornIn>	<Manchester>
<Sanchez_Watt>	<isCitizenOf>	<Russia>
<East_Asia>	<isCitizenOf>	<Serbia>
<George_McNestry>	<playsFor>	<Sunderland_A.F.C.>
<Glen_Southam>	<playsFor>	<Eastleigh_F.C.>
<John_Keeley>	<isAffiliatedTo>	<Chester_City_F.C.>
<Graham_Greene_(actor)>	<actedIn>	<The_Green_Mile_(film)>
<Nathan_Fillion>	<isCitizenOf>	<El_Salvador>
<Bill_Wyman>	<wasBornIn>	<Lewisham>
<Shefki_Kuqi>	<isCitizenOf>	<Germany>
<Adam_Proudlock>	<isCitizenOf>	<Netherlands>
<Kazakhstan>	<dealsWith>	<Germany>
<India>	<isCitizenOf>	<Norway>
<Dave_Hanson_(footballer)>	<isAffiliatedTo>	<Welling_United_F.C.>
<Jerry_Siegel>	<isCitizenOf>	<Kazakhstan>
<Fresno_County,_California>	<isLocatedIn>	<Fresno,_California>
<Andy_O'Brien_(footballer)>	<isAffiliatedTo>	<Bolton_Wanderers_F.C.>
<Dean_McDonald>	<playsFor>	<Ipswich_Town_F.C.>
<Himesh_Reshammiya>	<isCitizenOf>	<Sweden>
<John_Rawls>	<isCitizenOf>	<Belgium>
<Mike_Salmon>	<isCitizenOf>	<Slovenia>
<John_Byrne_(footballer,_born_1939)>	<isAffiliatedTo>	<Barnsley_F.C.>
<Paul_Holsgrove>	<isAffiliatedTo>	<Brighton_&_Hove_Albion_F.C.>
<Mich>	<isCitizenOf>	<Puerto_Rico>
<Shlomi_Arbeitman>	<isAffiliatedTo>	<Hapoel_Haifa_F.C.>
<Gavin_Ward_(footballer)>	<playsFor>	<Hednesford_Town_F.C.>
<Vince_Gilligan>	<isCitizenOf>	<Denmark>
<Andrew_Lloyd_Webber>	<isCitizenOf>	<England>
<Eddie_Albert>	<wasBornIn>	<Rock_Island,_Illinois>
<United_States_Virgin_Islands>	<isLocatedIn>	<United_States>
<82nd_Academy_Awards>	<isCitizenOf>	<United_States>
<James_Quinn_(footballer)>	<isCitizenOf>	<United_Kingdom>
<Keith_Bertschin>	<isAffiliatedTo>	<Birmingham_City_F.C.>
<Another_Year_(film)>	<isLocatedIn>	<United_Kingdom>
<Philippe_Senderos>	<playsFor>	<Rangers_F.C.>
<Guinea-Bissau>	<participatedIn>	<Northern_Mali_conflict>
<Huntington,_New_York>	<isCitizenOf>	<Bulgaria>
<Lateef_Elford-Alliyu>	<playsFor>	<Crawley_Town_F.C.>
<Jonatan_Johansson_(footballer)>	<isCitizenOf>	<United_States>
<Fat_Joe>	<isCitizenOf>	<United_States>
<Shirley_MacLaine>	<isCitizenOf>	<Monaco>
<Aaron_Brown_(footballer,_born_1980)>	<playsFor>	<Lincoln_City_F.C.>
<Jamal_Alioui>	<isCitizenOf>	<Switzerland>
<Trent_Reznor>	<wroteMusicFor>	<The_Social_Network>
<Alfredo_Foni>	<isCitizenOf>	<Australia>
<Richie_Foran>	<isCitizenOf>	<France>
<Pascal_Chimbonda>	<isCitizenOf>	<France>
<Michael_Danzey>	<playsFor>	<Nottingham_Forest_F.C.>
<Carlos_Ruiz_(Guatemalan_footballer)>	<playsFor>	<D.C._United>
<Martin_Paterson>	<isCitizenOf>	<Russia>
<Ömer_Rıza>	<isCitizenOf>	<England>
<Santa_Monica,_California>	<isCitizenOf>	<Jamaica>
<Jimi_Hendrix>	<isCitizenOf>	<Republic_of_the_Congo>
<Micky_Adams>	<isCitizenOf>	<Spain>
<Kamloops>	<isCitizenOf>	<Bangladesh>
<Mischa_Barton>	<isCitizenOf>	<England>
<Adel_Taarabt>	<isAffiliatedTo>	<Queens_Park_Rangers_F.C.>
<United_Nations_Operation_in_Somalia_II>	<happenedIn>	<Somalia>
<Westminster_School>	<isLocatedIn>	<City_of_Westminster>
<Charlie_Miller>	<isCitizenOf>	<Scotland>
<Terry_Dunfield>	<isAffiliatedTo>	<Canada_men's_national_soccer_team>
<Anonymous_(film)>	<isLocatedIn>	<United_Kingdom>
<Larry_Cohen>	<isCitizenOf>	<United_States>
<Edward_Zwick>	<directed>	<The_Last_Samurai>
<Samuel_M._Comer>	<isCitizenOf>	<United_States>
<James_O'Connor_(footballer,_born_1984)>	<playsFor>	<Walsall_F.C.>
<Wehrmacht>	<isLocatedIn>	<Nazi_Germany>
<Tommy_Wright_(footballer,_born_1963)>	<isAffiliatedTo>	<Nottingham_Forest_F.C.>
<Lesser_Antilles>	<isCitizenOf>	<Serbia>
<Jimi_Hendrix>	<diedIn>	<Kensington>
<Chris_Killen>	<isCitizenOf>	<France>
<Ed_O'Neill>	<isCitizenOf>	<Kazakhstan>
<Mark_Bowen_(footballer)>	<isCitizenOf>	<United_States>
<Youngstown,_Ohio>	<isLocatedIn>	<Trumbull_County,_Ohio>
<Lee_Ho_(footballer,_born_1984)>	<isAffiliatedTo>	<South_Korea_national_football_team>
<Jocky_Wright>	<isAffiliatedTo>	<Watford_F.C.>
<Mark_Yates_(footballer)>	<isAffiliatedTo>	<Birmingham_City_F.C.>
<Ralph_Bellamy>	<isCitizenOf>	<United_States>
<Tom_Hanks>	<actedIn>	<The_Green_Mile_(film)>
<Edward_Shearmur>	<wasBornIn>	<London>
<Lucas_Silva_(footballer,_born_1984)>	<isCitizenOf>	<France>
<Patricia_Arquette>	<isCitizenOf>	<Norway>
<Animax>	<isCitizenOf>	<Niger>
<Alex_Manninger>	<isAffiliatedTo>	<ACF_Fiorentina>
<Basil_Poledouris>	<wroteMusicFor>	<RoboCop>
<Herbert_Hoover>	<isCitizenOf>	<Canada>
<Lewis_Guy>	<playsFor>	<Newcastle_United_F.C.>
<Reg_Keating>	<playsFor>	<Birmingham_City_F.C.>
<John_Seasman>	<isAffiliatedTo>	<Rotherham_United_F.C.>
<1932_Summer_Olympics>	<isCitizenOf>	<Cyprus>
<Juan_Pablo_Sorín>	<isCitizenOf>	<Argentina>
<Jim_McDonagh>	<isAffiliatedTo>	<Notts_County_F.C.>
<Des_Lyttle>	<isCitizenOf>	<India>
<Gary_Kelly_(footballer,_born_1966)>	<isCitizenOf>	<England>
<Shatrughan_Sinha>	<isCitizenOf>	<Niger>
<Dallas>	<isCitizenOf>	<Canada>
<Rashida_Jones>	<wasBornIn>	<Los_Angeles>
<Harry_Roberts_(footballer,_born_1907)>	<wasBornIn>	<Barrow-in-Furness>
<Kenya>	<participatedIn>	<Operation_Enduring_Freedom>
<Fumaça_(footballer,_born_1976)>	<isCitizenOf>	<England>
<Jim_McCalliog>	<isCitizenOf>	<El_Salvador>
<Lilian_Nalis>	<isCitizenOf>	<China>
<Chris_Makin>	<isCitizenOf>	<Canada>
<Jim_Goodwin>	<playsFor>	<Hamilton_Academical_F.C.>
<Alphonse_Tchami>	<isCitizenOf>	<Greece>
<Joe_Garner>	<isAffiliatedTo>	<Blackburn_Rovers_F.C.>
<Simeon_Hodson>	<isCitizenOf>	<Barbados>
<Richard_Sylbert>	<isCitizenOf>	<Barbados>
<Belgrade>	<isLocatedIn>	<Serbia>
<Queen_Victoria>	<created>	<Royal_Victorian_Order>
<West_Java>	<hasWonPrize>	<Nobel_Prize_in_Physics>
<Peter_Marinello>	<wasBornIn>	<Edinburgh>
<Grzegorz_Szamotulski>	<isAffiliatedTo>	<Legia_Warsaw>
<Manny_Panther>	<isCitizenOf>	<Serbia>
<Nikodimos_Papavasiliou>	<isAffiliatedTo>	<Manager_(association_football)>
<Leighton_Meester>	<isCitizenOf>	<Puerto_Rico>
<Anthony_Williams_(footballer)>	<isCitizenOf>	<Poland>
<Jon_Newby>	<isAffiliatedTo>	<Crewe_Alexandra_F.C.>
<Gus_Uhlenbeek>	<playsFor>	<Mansfield_Town_F.C.>
<Dimitar_Makriev>	<isAffiliatedTo>	<Inter_Milan>
<Ben_Harding>	<isCitizenOf>	<England>
<Toho>	<isCitizenOf>	<United_States>
<Toby_Ajala>	<isAffiliatedTo>	<Gateshead_F.C.>
<Law_&_Order>	<isLocatedIn>	<United_States>
<David_Thewlis>	<actedIn>	<Anonymous_(film)>
<Belarus>	<hasNeighbor>	<Lithuania>
<Luis_Alonso_Sandoval>	<isCitizenOf>	<Barbados>
<Electric_Daisy_Carnival>	<isCitizenOf>	<Japan>
<Adam_Proudlock>	<isAffiliatedTo>	<Ipswich_Town_F.C.>
<Luciano_Figueroa>	<isCitizenOf>	<Serbia>
<Wuhan>	<isCitizenOf>	<Brazil>
<Fred_Williamson>	<isCitizenOf>	<Hungary>
<SV_Darmstadt_98>	<isCitizenOf>	<Germany>
<Frankie_Sutherland>	<isAffiliatedTo>	<Woking_F.C.>
<Alan_Fettis>	<isAffiliatedTo>	<Nottingham_Forest_F.C.>
<Jimmy_Miller_(footballer)>	<isAffiliatedTo>	<Coventry_City_F.C.>
<Reece_Brown>	<isCitizenOf>	<England>
<John_Sutton_(footballer)>	<playsFor>	<Tottenham_Hotspur_F.C.>
<Sean_Hayes_(actor)>	<isCitizenOf>	<Serbia>
<Tokyo>	<isCitizenOf>	<Greece>
<Zoran_Rajović>	<isCitizenOf>	<Israel>
<Etta_James>	<hasWonPrize>	<Grammy_Award>
<Paul_Musselwhite>	<isCitizenOf>	<Italy>
<Billy_Hendry>	<isCitizenOf>	<Bulgaria>
<Joe_Walters_(footballer)>	<isAffiliatedTo>	<Rochdale_A.F.C.>
<Sean_Astin>	<actedIn>	<Click_(2006_film)>
<Liam_Miller>	<isCitizenOf>	<Spain>
<Scott_Brown_(footballer,_born_April_1985)>	<isCitizenOf>	<Bahrain>
<Lauren_Bacall>	<isCitizenOf>	<Poland>
<James_Ingram>	<isCitizenOf>	<Croatia>
<Ashley_Bayes>	<isAffiliatedTo>	<AFC_Wimbledon>
<Ryan_Reynolds>	<actedIn>	<Smokin'_Aces>
<Peter_Gilbert>	<isAffiliatedTo>	<Leicester_City_F.C.>
<Dave_Grohl>	<isCitizenOf>	<France>
<Danny_Cullip>	<isAffiliatedTo>	<Brighton_&_Hove_Albion_F.C.>
<Bruno_Rodriguez>	<isCitizenOf>	<Russia>
<Dean_Hammond>	<isCitizenOf>	<Scotland>
<Edmund_Husserl>	<isCitizenOf>	<Wales>
<Alan_Thompson_(footballer,_born_1973)>	<isCitizenOf>	<Croatia>
<Sally_Field>	<actedIn>	<ER_(TV_series)>
<Emile_Kuri>	<isCitizenOf>	<United_States>
<Sean_Newton>	<isCitizenOf>	<England>
<Dean_Saunders>	<isAffiliatedTo>	<Oxford_United_F.C.>
<Simon_Colosimo>	<isCitizenOf>	<Israel>
<Sanchez_Watt>	<isAffiliatedTo>	<Leeds_United_F.C.>
<nl/UNAMIS>	<isLocatedIn>	<Norway>
<English_Civil_War>	<happenedIn>	<Kingdom_of_England>
<K.A.A._Gent>	<isCitizenOf>	<Republic_of_Ireland>
<Bonnie_Hunt>	<actedIn>	<A_Bug's_Life>
<Sean_Connery>	<isCitizenOf>	<Barbados>
<Derek_Jacobi>	<isCitizenOf>	<Scotland>
<Dave_Grohl>	<hasWonPrize>	<Grammy_Award>
<Ed_Helms>	<actedIn>	<The_Hangover>
<George_Kirby_(footballer)>	<playsFor>	<Brentford_F.C.>
<Japan>	<isCitizenOf>	<Kazakhstan>
<Peter_Beadle>	<playsFor>	<Port_Vale_F.C.>
<Scott_Davies_(footballer,_born_1988)>	<isCitizenOf>	<Ukraine>
<Simon_Whaley>	<isCitizenOf>	<Belgium>
<Diane_Warren>	<isCitizenOf>	<Germany>
<Louis_Saha>	<wasBornIn>	<Paris>
<Surrey,_British_Columbia>	<isCitizenOf>	<Serbia>
<Paul_Butler_(footballer,_born_1972)>	<isCitizenOf>	<Scotland>
<Neville_Roach>	<playsFor>	<Farnborough_F.C.>
<46th_Academy_Awards>	<isCitizenOf>	<Sweden>
<George_Segal>	<isCitizenOf>	<Russia>
<Gerry_Creaney>	<isCitizenOf>	<Scotland>
<New_Rochelle,_New_York>	<isLocatedIn>	<United_States>
<Gertrude_Stein>	<isCitizenOf>	<Iran>
<Barry_Richardson_(English_footballer)>	<isAffiliatedTo>	<Wycombe_Wanderers_F.C.>
<Chiyoda,_Tokyo>	<isCitizenOf>	<Australia>
<Alessandro_Rosina>	<isAffiliatedTo>	<A.C._Cesena>
<Kingdom_of_Naples>	<isCitizenOf>	<Martinique>
<Colin_Gordon_(footballer)>	<isCitizenOf>	<Slovenia>
<Jennifer_Connelly>	<livesIn>	<Brooklyn>
<Juan_Manuel_Olivera>	<isCitizenOf>	<Chile>
<Douglas_Fairbanks>	<isCitizenOf>	<United_States>
<nl/UNAMIS>	<isCitizenOf>	<Republic_of_Ireland>
<Amara_Simba>	<isCitizenOf>	<France>
<Concord,_New_Hampshire>	<isLocatedIn>	<New_Hampshire>
<Carthage>	<isLocatedIn>	<Tunisia>
<Raphael_Meade>	<isAffiliatedTo>	<Odense_Boldklub>
<Eric_Jones_(footballer,_born_1915)>	<isCitizenOf>	<Russia>
<Queen_Victoria>	<isCitizenOf>	<El_Salvador>
<Ariel_Graziani>	<isAffiliatedTo>	<Newell's_Old_Boys>
<Gloria_Stuart>	<isCitizenOf>	<United_States>
<Tim_Curry>	<actedIn>	<Terry_Pratchett's_The_Colour_of_Magic>
<Monsef_Zerka>	<playsFor>	<Calcio_Catania>
<Hans_Zimmer>	<isCitizenOf>	<United_Arab_Emirates>
<Ian_Harte>	<isCitizenOf>	<Canada>
<Willem_Dafoe>	<actedIn>	<Spider-Man_(2002_film)>
<Hugh_Laurie>	<actedIn>	<Arthur_Christmas>
<George_Kirby_(footballer)>	<isCitizenOf>	<Serbia>
<Road_to_Ultra>	<isCitizenOf>	<Iran>
<Chris_Cooper>	<actedIn>	<Capote_(film)>
<Emerson_(footballer,_born_1976)>	<isCitizenOf>	<Democratic_Republic_of_the_Congo>
<Clayton_McDonald>	<isCitizenOf>	<England>
<Eritrea>	<participatedIn>	<Operation_Enduring_Freedom_–_Horn_of_Africa>
<Stuart_McMillan_(footballer)>	<isCitizenOf>	<Argentina>
<Alex_Smith_(footballer,_born_1976)>	<isCitizenOf>	<England>
<Sacha_Opinel>	<isCitizenOf>	<Serbia>
<Shirley_MacLaine>	<actedIn>	<Cannonball_Run_II>
<Jimmy_Kennedy_(footballer)>	<isCitizenOf>	<Iran>
<Huntington,_New_York>	<isLocatedIn>	<New_York_metropolitan_area>
<James_Blunt>	<hasWonPrize>	<Brit_Awards>
<Béla_Guttmann>	<isAffiliatedTo>	<Panathinaikos_F.C.>
<Poland>	<isCitizenOf>	<Serbia>
<Bertrand_Bossu>	<isCitizenOf>	<Poland>
<Barry_Levinson>	<isCitizenOf>	<Senegal>
<Sylvia_Sidney>	<isCitizenOf>	<Japan>
<Chris_Palmer_(footballer)>	<isCitizenOf>	<Switzerland>
<Steven_Soderbergh>	<isCitizenOf>	<Sweden>
<War_of_the_First_Coalition>	<happenedIn>	<Kingdom_of_Naples>
<Tommy_Anderson_(footballer)>	<isAffiliatedTo>	<Stockport_County_F.C.>
<Uma_Thurman>	<isCitizenOf>	<Scotland>
<Meagan_Good>	<actedIn>	<The_Love_Guru>
<Matthew_McConaughey>	<hasWonPrize>	<Independent_Spirit_Award_for_Best_Male_Lead>
<Belgrade>	<isCitizenOf>	<Republic_of_Ireland>
<Lincoln_City_F.C.>	<isLocatedIn>	<Lincoln,_England>
<Michael_Phelps>	<isCitizenOf>	<England>
<Luis_Alonso_Sandoval>	<isAffiliatedTo>	<Monarcas_Morelia>
<Robert_Loggia>	<actedIn>	<Lost_Highway_(film)>
<Igor_Mitreski>	<isAffiliatedTo>	<FC_Metalurh_Zaporizhya>
<Gregor_Rioch>	<isAffiliatedTo>	<Macclesfield_Town_F.C.>
<James_Tavernier>	<isCitizenOf>	<Italy>
<Kevin_Austin>	<isAffiliatedTo>	<Leyton_Orient_F.C.>
<Lincoln_City_F.C.>	<isCitizenOf>	<Senegal>
<Equatorial_Guinea>	<hasOfficialLanguage>	<Spanish_language>
<Neil_Shipperley>	<isAffiliatedTo>	<Brentford_F.C.>
<Marcus_Haber>	<isCitizenOf>	<Bulgaria>
<Aron_Winter>	<isAffiliatedTo>	<AFC_Ajax>
<Late_Show_(CBS_TV_series)>	<isLocatedIn>	<United_States>
<Andy_Gray_(footballer,_born_1964)>	<isAffiliatedTo>	<England_national_football_team>
<Alejandro_Scopelli>	<isAffiliatedTo>	<Valencia_CF>
<Gavin_Hoyte>	<isCitizenOf>	<Poland>
<Michael_Shannon>	<isCitizenOf>	<Chile>
<Louie_Soares>	<playsFor>	<Ebbsfleet_United_F.C.>
<Richard_Dreyfuss>	<isCitizenOf>	<El_Salvador>
<Chiyoda,_Tokyo>	<isLocatedIn>	<Tokyo>
<Dele_Adebola>	<playsFor>	<Rochdale_A.F.C.>
<Frances_Marion>	<diedIn>	<Los_Angeles>
<Matt_Elliott_(footballer)>	<isCitizenOf>	<Martinique>
<Province_of_Como>	<isLocatedIn>	<Como>
<Kemar_Roofe>	<isAffiliatedTo>	<Leeds_United_F.C.>
<Abel_Xavier>	<isAffiliatedTo>	<PSV_Eindhoven>
<Darius_Henderson>	<isCitizenOf>	<England>
<Ben_Wilkinson>	<isAffiliatedTo>	<Altrincham_F.C.>
<Vietnam>	<isLocatedIn>	<Asia>
<Bert_Powell>	<isAffiliatedTo>	<Chesterfield_F.C.>
<Clinton_Morrison>	<isAffiliatedTo>	<Colchester_United_F.C.>
<Assassins_(film)>	<isCitizenOf>	<Iran>
<John_Sheridan_(footballer)>	<isCitizenOf>	<United_Kingdom>
<Eiður_Guðjohnsen>	<isCitizenOf>	<England>
<Alan_Daley>	<isAffiliatedTo>	<Cambridge_United_F.C.>
<Jason_Flemyng>	<isCitizenOf>	<Bahrain>
<Amartya_Sen>	<isCitizenOf>	<Bangladesh>
<John_Rawls>	<graduatedFrom>	<Massachusetts_Institute_of_Technology>
<Mohamed_Sissoko>	<isAffiliatedTo>	<Levante_UD>
<Simon_Callow>	<actedIn>	<Shakespeare_in_Love>
<Gary_Alexander_(footballer)>	<isAffiliatedTo>	<AFC_Wimbledon>
<New_Brunswick>	<isCitizenOf>	<Puerto_Rico>
<Karan_Johar>	<directed>	<My_Name_Is_Khan>
<Billy_Zane>	<actedIn>	<The_Believer_(film)>
<New_England_Conservatory_of_Music>	<isLocatedIn>	<Massachusetts>
<Matuzalém>	<playsFor>	<S.S._Lazio>
<Daniel_Jones_(footballer)>	<isAffiliatedTo>	<Notts_County_F.C.>
<David_Hilbert>	<isCitizenOf>	<Russia>
<Colin_Hendry>	<isCitizenOf>	<Martinique>
<Trent_Reznor>	<isCitizenOf>	<United_Arab_Emirates>
<Pontifical_Gregorian_University>	<isLocatedIn>	<Italy>
<Axis_powers>	<isCitizenOf>	<Austria>
<Charles_Brackett>	<created>	<Sunset_Boulevard_(film)>
<James_Fox>	<wasBornIn>	<London>
<Paul_Auster>	<wasBornIn>	<Newark,_New_Jersey>
<Sean_Hayes_(actor)>	<wasBornIn>	<Chicago>
<Toumani_Diagouraga>	<isCitizenOf>	<Slovenia>
<Sanctuary_Records>	<isCitizenOf>	<Switzerland>
<Derek_Jacobi>	<hasWonPrize>	<Tony_Award>
<Costa_Rica>	<dealsWith>	<Mexico>
<Angels_&_Airwaves_Presents_Love_Live>	<isCitizenOf>	<Israel>
<Matt_Dillon>	<isCitizenOf>	<Norway>
<Jason_Euell>	<isCitizenOf>	<Jamaica>
<Ivory_Coast>	<isCitizenOf>	<Bulgaria>
<Jean-Philippe_Javary>	<isCitizenOf>	<Serbia>
<Gary_Alexander_(footballer)>	<isCitizenOf>	<Croatia>
<Robert_Louis_Stevenson>	<influences>	<Arthur_Conan_Doyle>
<Robert_de_Pinho_de_Souza>	<isCitizenOf>	<Brazil>
<Brett_Angell>	<isCitizenOf>	<Barbados>
<Jamaica>	<dealsWith>	<Canada>
<Davide_Dionigi>	<playsFor>	<A.C._Milan>
<Carl_Alford>	<isCitizenOf>	<Scotland>
<Anthony_Williams_(footballer)>	<isAffiliatedTo>	<Bury_F.C.>
<Pablo_Mills>	<isCitizenOf>	<Netherlands>
<Martin_Short>	<actedIn>	<The_Spiderwick_Chronicles_(film)>
<Worcester_County,_Massachusetts>	<isLocatedIn>	<Worcester,_Massachusetts>
<Bam_Margera>	<actedIn>	<Jackass_3D>
<Chris_Killen>	<playsFor>	<Wrexham_A.F.C.>
<Frank_Fielding>	<isCitizenOf>	<Republic_of_the_Congo>
<Emma_Thompson>	<isCitizenOf>	<China>
<Armenia>	<isCitizenOf>	<Tanzania>
<Sangamon_County,_Illinois>	<isCitizenOf>	<Russia>
<Alexander_Hleb>	<isCitizenOf>	<Jamaica>
<James_L._Brooks>	<hasWonPrize>	<Writers_Guild_of_America_Award>
<Leighton_Meester>	<wasBornIn>	<Fort_Worth,_Texas>
<Elliot_Goldenthal>	<wroteMusicFor>	<Frida>
<Lewis_Montrose>	<isAffiliatedTo>	<Wigan_Athletic_F.C.>
<45th_Annual_Grammy_Awards>	<isLocatedIn>	<New_York_City>
<Rosemary_Harris>	<actedIn>	<Sunshine_(1999_film)>
<Song_Chong-gug>	<isCitizenOf>	<Israel>
<Derek_McInnes>	<isCitizenOf>	<United_Kingdom>
<Noah_Taylor>	<wasBornIn>	<London>
<Tony_Pulis>	<isCitizenOf>	<Cyprus>
<John_Malkovich>	<isCitizenOf>	<Cameroon>
<Eric_Jones_(footballer,_born_1915)>	<playsFor>	<Kidderminster_Harriers_F.C.>
<Young_Adam_(film)>	<isCitizenOf>	<Bahrain>
<Habsburg_Monarchy>	<isCitizenOf>	<Republic_of_Ireland>
<Claude_Davis>	<isCitizenOf>	<Bulgaria>
<Horace_Brindley>	<isCitizenOf>	<Nigeria>
<Artie_Lange>	<isCitizenOf>	<Bahrain>
<Jack_Nicholson>	<actedIn>	<A_Few_Good_Men>
<Appalachian_Mountains>	<isLocatedIn>	<Virginia>
<Dennis_Oli>	<isCitizenOf>	<Jamaica>
<Stephen_Warnock>	<isCitizenOf>	<Senegal>
<Jacques_Derrida>	<isCitizenOf>	<Democratic_Republic_of_the_Congo>
<Bruno_Marioni>	<isAffiliatedTo>	<Villarreal_CF>
<Thomas_Newman>	<wroteMusicFor>	<In_the_Bedroom>
<George_Lucas>	<graduatedFrom>	<University_of_Southern_California>
<Lilo_&_Stitch>	<isLocatedIn>	<United_States>
<Richie_Ryan_(footballer)>	<isCitizenOf>	<Belgium>
<2017_Romanian_protests>	<happenedIn>	<Vienna>
<Hugo_Weaving>	<actedIn>	<The_Matrix>
<Eddie_McGoldrick>	<isAffiliatedTo>	<Republic_of_Ireland_national_football_team>
<Surrey,_British_Columbia>	<isLocatedIn>	<British_Columbia>
<Romania>	<isCitizenOf>	<United_Arab_Emirates>
<Jean-Philippe_Javary>	<wasBornIn>	<Montpellier>
<Inyo_County,_California>	<isCitizenOf>	<Cameroon>
<Fergie_(singer)>	<isCitizenOf>	<Ukraine>
<Bram_Stoker>	<isCitizenOf>	<England>
<Matteo_Brighi>	<isCitizenOf>	<Austria>
<2009_Iranian_presidential_election_protests>	<happenedIn>	<Halifax,_Nova_Scotia>
<English_Civil_War>	<isCitizenOf>	<Martinique>
<Edgar_Rice_Burroughs>	<isCitizenOf>	<Russia>
<Ian_Redford>	<wasBornIn>	<Perth,_Scotland>
<Stephen_Dawson>	<isCitizenOf>	<Martinique>
<Linda_Cardellini>	<actedIn>	<Super_(2010_American_film)>
<Trevor_Ross>	<isAffiliatedTo>	<AEK_Athens_F.C.>
<Paul_Holsgrove>	<isCitizenOf>	<Dominica>
<Thomas_Ian_Nicholas>	<isCitizenOf>	<Sweden>
<Sam_Neill>	<isCitizenOf>	<Switzerland>
<John_Cairns_(footballer)>	<playsFor>	<Leicester_City_F.C.>
<Danny_McLennan>	<isCitizenOf>	<Bahrain>
<Amsterdam>	<isLocatedIn>	<North_Holland>
<Pamela_Anderson>	<isCitizenOf>	<United_Kingdom>
<Gustavo_Franchin_Schiavolin>	<isCitizenOf>	<Russia>
<Alex_Graves>	<wasBornIn>	<Kansas_City,_Missouri>
<Hugo_Weaving>	<isCitizenOf>	<United_Kingdom>
<Tom_Flanagan_(footballer)>	<isCitizenOf>	<Italy>
<Province_of_Como>	<isCitizenOf>	<Tanzania>
<Worthing>	<isLocatedIn>	<Sussex>
<Daniel_Nardiello>	<isCitizenOf>	<Martinique>
<Lee_Holmes>	<isAffiliatedTo>	<Portsmouth_F.C.>
<Nicky_Shorey>	<isAffiliatedTo>	<England_national_football_team>
<Yoko_Ono>	<isMarriedTo>	<John_Lennon>
<Jack_Nicholson>	<isCitizenOf>	<Argentina>
<Danny_Haynes>	<isAffiliatedTo>	<Bristol_City_F.C.>
<Andy_Dow>	<isCitizenOf>	<Bulgaria>
<Kaba_Diawara>	<isCitizenOf>	<Jamaica>
<Kevin_Summerfield>	<playsFor>	<Cardiff_City_F.C.>
<Kelvin_Langmead>	<isCitizenOf>	<Cameroon>
<2009_Sundance_Film_Festival>	<isLocatedIn>	<Ogden,_Utah>
<Jamie_Day_(footballer,_born_1979)>	<isCitizenOf>	<Cameroon>
<Liam_George>	<isCitizenOf>	<Bangladesh>
<Bon_Jovi>	<isCitizenOf>	<England>
<Michael_Owen>	<wasBornIn>	<Chester>
<Gordon_Hill_(footballer)>	<isCitizenOf>	<Niger>
<Stephen_Dillane>	<isCitizenOf>	<England>
<Rory_Fallon>	<isCitizenOf>	<Brazil>
<Jimmy_Quinn_(footballer,_born_1959)>	<playsFor>	<Hereford_United_F.C.>
<Ryan_McCann>	<isAffiliatedTo>	<Ayr_United_F.C.>
<Indo-Pakistani_War_of_1971>	<isLocatedIn>	<Bangladesh>
<Dallas>	<isLocatedIn>	<Texas>
<Donna_Summer>	<wasBornIn>	<Boston>
<Aly_Cissokho>	<isCitizenOf>	<Northern_Ireland>
<Macalester_College>	<isCitizenOf>	<Northern_Ireland>
<Scott_Loach>	<isAffiliatedTo>	<Notts_County_F.C.>
<Elliot_Goldenthal>	<isCitizenOf>	<Cape_Verde>
<Jennifer_Lopez>	<isCitizenOf>	<Puerto_Rico>
<Michael_Cera>	<isCitizenOf>	<Chile>
<Michael_Stipe>	<isCitizenOf>	<Russia>
<Charles_Darwin>	<isCitizenOf>	<Sweden>
<Nick_Wright_(footballer,_born_1987)>	<isCitizenOf>	<England>
<Rob_Corddry>	<isCitizenOf>	<United_States>
<Alex_Taylor_(footballer)>	<isCitizenOf>	<Nigeria>
<Alfredo_Foni>	<isAffiliatedTo>	<Italy_national_football_team>
<2K_Games>	<isLocatedIn>	<United_States>
<John_Eustace>	<isCitizenOf>	<Tanzania>
<Orange_County,_California>	<isLocatedIn>	<California>
<Jimmy_Kennedy_(footballer)>	<isAffiliatedTo>	<Swindon_Town_F.C.>
<Eminem>	<isCitizenOf>	<Tanzania>
<Béla_Guttmann>	<isCitizenOf>	<Brazil>
<Roberto_Benigni>	<isCitizenOf>	<Niger>
<Ian_Harte>	<isAffiliatedTo>	<Leeds_United_F.C.>
<Emanuele_Pesaresi>	<isAffiliatedTo>	<Ternana_Calcio>
<Julian_de_Guzman>	<isAffiliatedTo>	<Canada_men's_national_soccer_team>
<Justin_Chambers>	<isCitizenOf>	<Ukraine>
<Carlos_Tevez>	<isCitizenOf>	<Argentina>
<82nd_Academy_Awards>	<happenedIn>	<Hollywood>
<Danny_Andrew>	<isCitizenOf>	<Cape_Verde>
<Jon_Dahl_Tomasson>	<isAffiliatedTo>	<Roda_JC_Kerkrade>
<Moses_Sakyi>	<isAffiliatedTo>	<Liberty_Professionals_F.C.>
<Marion_County,_Florida>	<isLocatedIn>	<Florida>
<John_Michael_Higgins>	<actedIn>	<A_Mighty_Wind>
<Matt_McNeil>	<playsFor>	<Cambridge_United_F.C.>
<Michael_Bridges>	<isCitizenOf>	<Martinique>
<Wayne_Gray_(footballer)>	<isCitizenOf>	<Denmark>
<Greg_Pearson>	<isCitizenOf>	<Australia>
<Paul_Gascoigne>	<isAffiliatedTo>	<Kettering_Town_F.C.>
<Arthur_Beadsworth>	<isCitizenOf>	<Democratic_Republic_of_the_Congo>
<11Eleven_Project>	<isCitizenOf>	<Israel>
<Jeff_Wealands>	<isAffiliatedTo>	<Northampton_Town_F.C.>
<Drissa_Diallo>	<isCitizenOf>	<France>
<Ian_Muir>	<isAffiliatedTo>	<Birmingham_City_F.C.>
<Pablo_Mills>	<isAffiliatedTo>	<Derby_County_F.C.>
<Dominican_Republic>	<hasOfficialLanguage>	<Spanish_language>
<George_Hamilton_(actor)>	<isCitizenOf>	<Mali>
<Tony_Lormor>	<isCitizenOf>	<Cyprus>
<Steve_Leo_Beleck>	<isCitizenOf>	<Belgium>
<Myles_Weston>	<isCitizenOf>	<Austria>
<British_Columbia>	<isCitizenOf>	<Israel>
<Paul_Auster>	<isCitizenOf>	<Scotland>
<Shatrughan_Sinha>	<wasBornIn>	<Patna>
<Alfie_Conn_Jr.>	<isCitizenOf>	<Australia>
<Edward_Dmytryk>	<isCitizenOf>	<United_States>
<Alex_MacDonald_(footballer,_born_1990)>	<wasBornIn>	<Warrington>
<Kei_Kamara>	<isCitizenOf>	<Serbia>
<Peter_Barnes_(footballer)>	<isCitizenOf>	<Israel>
<Chris_Eagles>	<isAffiliatedTo>	<Watford_F.C.>
<Sabri_Lamouchi>	<isAffiliatedTo>	<Inter_Milan>
<Indo-Pakistani_War_of_1971>	<isCitizenOf>	<Republic_of_Ireland>
<James_Newton_Howard>	<wroteMusicFor>	<Mumford_(film)>
<Ralph_Fiennes>	<actedIn>	<The_English_Patient_(film)>
<Barry_Levinson>	<directed>	<Wag_the_Dog>
<Patti_Smith>	<isCitizenOf>	<United_States>
<CBS_Corporation>	<isLocatedIn>	<United_States>
<Moses_Sakyi>	<isCitizenOf>	<Kazakhstan>
<Allan_Russell>	<isCitizenOf>	<England>
<Trésor_Kandol>	<isCitizenOf>	<Republic_of_the_Congo>
<Art_Carney>	<isCitizenOf>	<Greece>
<King_Records_(United_States)>	<isLocatedIn>	<Cincinnati>
<XXX_(2002_film)>	<isCitizenOf>	<Australia>
<Jon_Bon_Jovi>	<isCitizenOf>	<United_States>
<John_Sutton_(footballer)>	<isCitizenOf>	<Republic_of_the_Congo>
<Brendan_Gleeson>	<isCitizenOf>	<Dominica>
<Alastair_Reynolds>	<isCitizenOf>	<United_Kingdom>
<Olof_Mellberg>	<isAffiliatedTo>	<AIK_Fotboll>
<Bill_McGarry>	<isCitizenOf>	<Cameroon>
<Raúl_Díaz_Arce>	<isCitizenOf>	<United_Kingdom>
<George_Florescu>	<isCitizenOf>	<Denmark>
<Frank_Fielding>	<isAffiliatedTo>	<Leeds_United_F.C.>
<David_Davis_(footballer)>	<isAffiliatedTo>	<Darlington_F.C.>
<Gary_Kelly_(footballer,_born_1966)>	<playsFor>	<Sheffield_United_F.C.>
<Elia_Kazan>	<isCitizenOf>	<Dominica>
<Giuseppe_Greco_(footballer,_born_1983)>	<isCitizenOf>	<Hungary>
<Raïs_M'Bolhi>	<isCitizenOf>	<Israel>
<Dean_Saunders>	<isCitizenOf>	<Australia>
<Alex_Rodman>	<isCitizenOf>	<France>
<Keith_Rowland>	<isCitizenOf>	<Germany>
<Greenwood,_Mississippi>	<isLocatedIn>	<United_States>
<Bora_Milutinović>	<isCitizenOf>	<Nigeria>
<United_States_Virgin_Islands>	<isCitizenOf>	<Northern_Ireland>
<Art_Carney>	<actedIn>	<Last_Action_Hero>
<Peter_Nicholas_(footballer)>	<wasBornIn>	<Newport,_Wales>
<Transylvania>	<isLocatedIn>	<Europe>
<Chris_Eagles>	<isCitizenOf>	<Democratic_Republic_of_the_Congo>
<Howard_Gordon>	<isCitizenOf>	<Canada>
<Mandatory_Palestine>	<isCitizenOf>	<Senegal>
<Steve_Robinson_(Northern_Ireland_footballer)>	<isAffiliatedTo>	<Luton_Town_F.C.>
<Riccardo_Meggiorini>	<playsFor>	<A.C._ChievoVerona>
<Maicon_Santos>	<isCitizenOf>	<Chile>
<Patrick_van_Aanholt>	<isAffiliatedTo>	<SBV_Vitesse>
<Louis_Saha>	<isCitizenOf>	<Austria>
<David_Thewlis>	<isCitizenOf>	<Ukraine>
<Concord,_New_Hampshire>	<isCitizenOf>	<United_Kingdom>
<Ingmar_Bergman>	<isCitizenOf>	<United_States>
<Lee_Ho_(footballer,_born_1984)>	<isCitizenOf>	<Hungary>
<Eiður_Guðjohnsen>	<playsFor>	<Molde_FK>
<Ariel_Graziani>	<isCitizenOf>	<China>
<Carl_Alford>	<playsFor>	<Stockport_County_F.C.>
<NBCUniversal>	<owns>	<Amblin_Entertainment>
<Steve_Torpey_(footballer,_born_1970)>	<isCitizenOf>	<Switzerland>
<Shohreh_Aghdashloo>	<hasWonPrize>	<Independent_Spirit_Awards>
<Simon_Cziommer>	<isCitizenOf>	<United_States>
<Chris_Makin>	<isAffiliatedTo>	<Reading_F.C.>
<David_Brightwell>	<playsFor>	<Bradford_City_A.F.C.>
<Iraq>	<dealsWith>	<Greece>
<Davide_Dionigi>	<playsFor>	<Spezia_Calcio>
<Karl_Ready>	<isAffiliatedTo>	<Farnborough_F.C.>
<Kevin_Phillips_(footballer)>	<isAffiliatedTo>	<Aston_Villa_F.C.>
<Conor_Sammon>	<playsFor>	<Ipswich_Town_F.C.>
<Warren_Aspinall>	<isCitizenOf>	<Slovenia>
<Kyle_MacLachlan>	<isCitizenOf>	<Cameroon>
<Innsbruck>	<isLocatedIn>	<Tyrol_(state)>
<Tangled>	<isLocatedIn>	<United_States>
<Dominic_West>	<isCitizenOf>	<Argentina>
<Pat_Terry>	<isCitizenOf>	<Russia>
<Boise_State_University>	<isLocatedIn>	<Boise,_Idaho>
<Yale_School_of_Medicine>	<isLocatedIn>	<New_Haven,_Connecticut>
<John_Keeley>	<isCitizenOf>	<Northern_Ireland>
<Alex_Manninger>	<isCitizenOf>	<Bangladesh>
<Andy_Serkis>	<actedIn>	<Inkheart_(film)>
<University_of_Vienna>	<isLocatedIn>	<Vienna>
<Nikodimos_Papavasiliou>	<playsFor>	<Newcastle_United_F.C.>
<Kinji_Fukasaku>	<isCitizenOf>	<Germany>
<Ottoman_Empire>	<participatedIn>	<Napoleonic_Wars>
<Robert_A._Heinlein>	<isCitizenOf>	<El_Salvador>
<Joseph_S._O'Leary>	<isInterestedIn>	<Georg_Wilhelm_Friedrich_Hegel>
<Conor_Sammon>	<isCitizenOf>	<Democratic_Republic_of_the_Congo>
<Arthur_Schopenhauer>	<isCitizenOf>	<Germany>
<Damjan_Đoković>	<isAffiliatedTo>	<A.S._Livorno_Calcio>
<Paul_Kinnaird>	<isAffiliatedTo>	<Shrewsbury_Town_F.C.>
<Michael_Laudrup>	<playsFor>	<S.S._Lazio>
<Bob_Curry>	<isCitizenOf>	<Switzerland>
<Animax>	<isLocatedIn>	<Cuba>
<Keith_Bertschin>	<isCitizenOf>	<England>
<Ferenc_Puskás>	<isAffiliatedTo>	<Panathinaikos_F.C.>
<Alan_J._Pakula>	<isCitizenOf>	<United_States>
<Andy_Ferrell>	<isAffiliatedTo>	<York_City_F.C.>
<Rubén_González_Rocha>	<isCitizenOf>	<Hungary>
<Edgar_Rice_Burroughs>	<influences>	<Peter_David>
<Sienna_Miller>	<wasBornIn>	<New_York_City>
<Jim_Fryatt>	<wasBornIn>	<Southampton>
<Wyatt_Cenac>	<isCitizenOf>	<United_States>
<Wayne_Cegielski>	<isAffiliatedTo>	<Port_Vale_F.C.>
<Peter_Molloy_(footballer,_born_1909)>	<playsFor>	<Queens_Park_Rangers_F.C.>
<Kumasi>	<isCitizenOf>	<England>
<Epic_Soundtrax>	<isLocatedIn>	<Los_Angeles>
<Brent_Sancho>	<isCitizenOf>	<Sweden>
<Coimbatore>	<isCitizenOf>	<Germany>
<Iraq>	<isCitizenOf>	<Kazakhstan>
<Lily_Tomlin>	<actedIn>	<And_the_Band_Played_On_(film)>
<Ludacris>	<created>	<Burning_Bridges_(Ludacris_EP)>
<Aaron_Shure>	<wasBornIn>	<United_States>
<Japan>	<hasCurrency>	<Japanese_yen>
<Loïc_Rémy>	<isAffiliatedTo>	<Olympique_Lyonnais>
<Thomas_Ian_Nicholas>	<actedIn>	<American_Pie_(film)>
<Rwanda>	<isCitizenOf>	<Japan>
<Clint_Eastwood>	<isCitizenOf>	<Russia>
<Larenz_Tate>	<actedIn>	<Ray_(film)>
<Patrick_Kanyuka>	<playsFor>	<Tamworth_F.C.>
<Stuart_McMillan_(footballer)>	<isAffiliatedTo>	<Gillingham_F.C.>
<James_Mason>	<isCitizenOf>	<Poland>
<Tommy_Wright_(footballer,_born_1963)>	<isCitizenOf>	<Ukraine>
<Michael_Owen>	<isCitizenOf>	<England>
<Parlophone>	<isCitizenOf>	<Niger>
<Mark_Pembridge>	<isCitizenOf>	<United_Kingdom>
<Lee_Fowler>	<isAffiliatedTo>	<Oxford_United_F.C.>
<Lee_Thorpe>	<isCitizenOf>	<Martinique>
<Richard_Burton>	<actedIn>	<Anne_of_the_Thousand_Days>
<Aimee_Mann>	<wasBornIn>	<Richmond,_Virginia>
<Craig_McAllister>	<isCitizenOf>	<Kazakhstan>
<Walter_Novellino>	<isCitizenOf>	<Italy>
<Derek_McInnes>	<isAffiliatedTo>	<Dundee_United_F.C.>
<Peter_Meehan>	<isAffiliatedTo>	<Clyde_F.C.>
<Monroe,_Louisiana>	<isLocatedIn>	<Louisiana>
<Evan_Rachel_Wood>	<isCitizenOf>	<Poland>
<Graham_Potter>	<playsFor>	<Birmingham_City_F.C.>
<Scouting_in_California>	<isCitizenOf>	<Republic_of_the_Congo>
<Henry_James>	<isCitizenOf>	<Democratic_Republic_of_the_Congo>
<Latvia>	<isCitizenOf>	<Puerto_Rico>
<Raphael_Meade>	<isCitizenOf>	<Tanzania>
<Astrit_Ajdarević>	<isAffiliatedTo>	<AEK_Athens_F.C.>
<Jordan_Parkes>	<isCitizenOf>	<Serbia>
<Hillsborough_County,_New_Hampshire>	<isCitizenOf>	<Argentina>
<The_Golden_Compass_(film)>	<isLocatedIn>	<United_States>
<Crispin_Freeman>	<wasBornIn>	<Chicago>
<Darren_Byfield>	<isCitizenOf>	<Hungary>
<Shanghai_Greenland_Shenhua_F.C.>	<isCitizenOf>	<Switzerland>
<Weber_State_University>	<isCitizenOf>	<Martinique>
<Bas_Savage>	<isAffiliatedTo>	<Gillingham_F.C.>
<Alessandro_Bastrini>	<playsFor>	<Calcio_Catania>
<Bondz_N'Gala>	<isCitizenOf>	<Greece>
<Les_Ferdinand>	<playsFor>	<Tottenham_Hotspur_F.C.>
<Richard_Burton>	<isCitizenOf>	<United_States>
<James_Newton_Howard>	<wroteMusicFor>	<The_Bourne_Legacy_(film)>
<North_Dakota>	<isCitizenOf>	<Dominica>
<Bruce_Greenwood>	<actedIn>	<Swept_Away_(2002_film)>
<Micky_Adams>	<isAffiliatedTo>	<Sheffield_United_F.C.>
<War_of_the_Spanish_Succession>	<happenedIn>	<South_America>
<Rajinikanth>	<wasBornIn>	<Bangalore>
<Andrew_Stanton>	<created>	<Finding_Nemo>
<Taking_Woodstock>	<isLocatedIn>	<United_States>
<Gary_McSheffrey>	<isCitizenOf>	<Republic_of_the_Congo>
<Les_Ferdinand>	<isCitizenOf>	<Senegal>
<Paul_Marshall_(footballer)>	<isCitizenOf>	<Democratic_Republic_of_the_Congo>
<Gustave_Flaubert>	<isCitizenOf>	<France>
<John_Malkovich>	<actedIn>	<The_Man_in_the_Iron_Mask_(1998_film)>
<Elizabeth_II>	<isCitizenOf>	<Austria>
<John_Burridge>	<isCitizenOf>	<Denmark>
<The_Vow_(2012_film)>	<isCitizenOf>	<Canada>
<Leroy_Lita>	<playsFor>	<Middlesbrough_F.C.>
<Niels_Bohr>	<isCitizenOf>	<Wales>
<Jordan_Rose>	<playsFor>	<A.F.C._Telford_United>
<Syria>	<hasCapital>	<Damascus>
<Ballet_Shoes_(film)>	<isCitizenOf>	<Wales>
<Sean_Connery>	<actedIn>	<The_Name_of_the_Rose_(film)>
<Chicago>	<isCitizenOf>	<Nigeria>
<Eddie_Kelly_(footballer)>	<isCitizenOf>	<England>
<Darius_Henderson>	<playsFor>	<Coventry_City_F.C.>
<Joni_Mitchell>	<isCitizenOf>	<Canada>
<Simon_Gillett>	<wasBornIn>	<Oxford>
<Bas_Savage>	<isAffiliatedTo>	<Bury_F.C.>
<Alex_MacDonald_(footballer,_born_1990)>	<isCitizenOf>	<Argentina>
<Shanghai_Greenland_Shenhua_F.C.>	<isLocatedIn>	<Shanghai>
<David_O._Selznick>	<isCitizenOf>	<United_States>
<Djamel_Abdoun>	<isCitizenOf>	<Poland>
<Branco_(footballer)>	<playsFor>	<New_York_Red_Bulls>
<Claude_Rains>	<hasWonPrize>	<Donaldson_Awards>
<Patrick_Suffo>	<isCitizenOf>	<Cyprus>
<Joaquin_Phoenix>	<actedIn>	<The_Master_(2012_film)>
<Byzantine_Empire>	<hasOfficialLanguage>	<Latin>
<Tarcisio_Burgnich>	<isAffiliatedTo>	<Juventus_F.C.>
<Henri_Lansbury>	<isCitizenOf>	<Martinique>
<Marcus_Hahnemann>	<isCitizenOf>	<Germany>
<James_O'Connor_(footballer,_born_1984)>	<isCitizenOf>	<Italy>
<Ardent_Records>	<isLocatedIn>	<Memphis,_Tennessee>
<Perry_Suckling>	<isCitizenOf>	<Republic_of_Ireland>
<Macalester_College>	<isLocatedIn>	<Minnesota>
<Mario_Puzo>	<isCitizenOf>	<Italy>
<Dean_Howell>	<isAffiliatedTo>	<Notts_County_F.C.>
<Ben_Hamer>	<isCitizenOf>	<Hungary>
<Dave_Mackay>	<diedIn>	<Nottingham>
<Jack_Nicholson>	<actedIn>	<Easy_Rider>
<Walt_Disney_Studios_Motion_Pictures>	<isCitizenOf>	<Brazil>
<Daniel_Inouye>	<hasWonPrize>	<Medal_of_Honor>
<Kim_Grant_(footballer)>	<isCitizenOf>	<Senegal>
<Rajasthan>	<isCitizenOf>	<Poland>
<Matt_Jackson>	<isAffiliatedTo>	<Watford_F.C.>
<Nikola_Vujadinović>	<wasBornIn>	<Belgrade>
<George_V>	<isCitizenOf>	<Wales>
<Neil_Shipperley>	<isCitizenOf>	<Cameroon>
<Paul_Haggis>	<livesIn>	<Santa_Monica,_California>
<Sydney_Pollack>	<isCitizenOf>	<United_Kingdom>
<Damjan_Đoković>	<isCitizenOf>	<Canada>
<Danny_Haynes>	<isCitizenOf>	<Germany>
<Patrick_Agyemang>	<isCitizenOf>	<Croatia>
<Martin_Hodge>	<isAffiliatedTo>	<Oldham_Athletic_A.F.C.>
<Steve_Anthrobus>	<isAffiliatedTo>	<Hednesford_Town_F.C.>
<Graham_Roberts>	<isCitizenOf>	<Puerto_Rico>
<Adrian_Littlejohn>	<isCitizenOf>	<Hungary>
<Venezuela>	<dealsWith>	<Spain>
<Jane_Lynch>	<actedIn>	<Role_Models>
<Clyde_Wijnhard>	<playsFor>	<Darlington_F.C.>
<Canada>	<participatedIn>	<Operation_Ocean_Shield>
<Patrick_van_Aanholt>	<isCitizenOf>	<Republic_of_Ireland>
<SV_Darmstadt_98>	<isLocatedIn>	<Darmstadt>
<Billy_Zane>	<isCitizenOf>	<Wales>
<Aimee_Mann>	<isCitizenOf>	<Barbados>
<Matthew_Perry>	<isCitizenOf>	<United_States>
<Russell_Brand>	<isCitizenOf>	<United_Kingdom>
<Sam_Russell_(footballer,_born_1982)>	<isCitizenOf>	<Mali>
<Ben_Purkiss>	<isCitizenOf>	<China>
<Rudi_Skácel>	<isCitizenOf>	<Italy>
<Danube>	<isCitizenOf>	<El_Salvador>
<Sunil_Dutt>	<isCitizenOf>	<India>
<Haim_Saban>	<isCitizenOf>	<Israel>
<Marco_Motta>	<playsFor>	<Watford_F.C.>
<Trevor_Aylott>	<isCitizenOf>	<Jamaica>
<New_Bedford,_Massachusetts>	<isCitizenOf>	<Ukraine>
<Sienna_Miller>	<isCitizenOf>	<Israel>
<Robert_A._Heinlein>	<influences>	<Charles_Stross>
<Peru>	<isCitizenOf>	<Netherlands>
<Sharon_Osbourne>	<isCitizenOf>	<England>
<Joan_Rivers>	<isCitizenOf>	<Mali>
<Guy_Branston>	<isCitizenOf>	<Chile>
<Algeria>	<isCitizenOf>	<Cape_Verde>
<Jimmy_Quinn_(footballer,_born_1959)>	<isCitizenOf>	<Denmark>
<Brian_Kidd>	<isAffiliatedTo>	<Bolton_Wanderers_F.C.>
<Abigail_Breslin>	<actedIn>	<Zombieland>
<Tony_Pulis>	<isAffiliatedTo>	<Bristol_Rovers_F.C.>
<King_Records_(United_States)>	<isCitizenOf>	<Iran>
<Brian_Rice_(footballer)>	<isCitizenOf>	<Cameroon>
<Rabindranath_Tagore>	<wasBornIn>	<Kolkata>
<Peter_Molloy_(footballer,_born_1909)>	<isCitizenOf>	<Australia>
<Rocky_Mountains>	<isLocatedIn>	<Wyoming>
<Miguel_de_Cervantes>	<influences>	<J._M._Coetzee>
<Michael_Spillane_(footballer)>	<isAffiliatedTo>	<Southend_United_F.C.>
<Dave_Halliday>	<isCitizenOf>	<Scotland>
<Romano_Perticone>	<playsFor>	<U.C._Sampdoria>
<Thomas_Newman>	<isCitizenOf>	<Norway>
<Winnipeg>	<isCitizenOf>	<Bahrain>
<Darryl_Flahavan>	<isAffiliatedTo>	<Crystal_Palace_F.C.>
<Billy_Crudup>	<isCitizenOf>	<Wales>
<Alex_Rhodes_(footballer)>	<isCitizenOf>	<England>
<Mick_Bodley>	<isAffiliatedTo>	<Peterborough_United_F.C.>
<Jean-Claude_Darcheville>	<isCitizenOf>	<France>
<Ian_James_Corlett>	<isCitizenOf>	<Russia>
<Innsbruck>	<isCitizenOf>	<Mali>
<John_McGuigan>	<playsFor>	<Swansea_City_A.F.C.>
<Dave_Metchick>	<playsFor>	<Woking_F.C.>
<Richard_Key>	<wasBornIn>	<Cambridge>
<Tom_Cowan>	<isAffiliatedTo>	<Sheffield_United_F.C.>
<Carly_Simon>	<isCitizenOf>	<Spain>
<Dieumerci_Mbokani>	<isCitizenOf>	<Democratic_Republic_of_the_Congo>
<Jimmy_Gauld>	<isAffiliatedTo>	<Everton_F.C.>
<Gainesville,_Florida>	<isLocatedIn>	<United_States>
<Frank_Worthington>	<isCitizenOf>	<United_Kingdom>
<Tom_Skerritt>	<isCitizenOf>	<United_Arab_Emirates>
<Grégory_Tadé>	<isCitizenOf>	<Senegal>
<Paul_Rachubka>	<isAffiliatedTo>	<Bury_F.C.>
<Ian_Hendon>	<isCitizenOf>	<Germany>
<Geoff_Scott_(footballer)>	<isCitizenOf>	<Northern_Ireland>
<Marvel_Entertainment>	<isCitizenOf>	<Nigeria>
<Lee_Holmes>	<isCitizenOf>	<Northern_Ireland>
<Amsterdam>	<isCitizenOf>	<Iran>
<Philip_Pullman>	<isCitizenOf>	<Bangladesh>
<Sanmi_Odelusi>	<isAffiliatedTo>	<Reading_F.C.>
<George_McNestry>	<isCitizenOf>	<Brazil>
<Robert_Earnshaw>	<isCitizenOf>	<Mali>
<Aron_Winter>	<isCitizenOf>	<Republic_of_the_Congo>
<Philip_Yordan>	<hasWonPrize>	<Edgar_Award>
<Adam_Griffiths>	<isCitizenOf>	<Australia>
<John_Moncur>	<isCitizenOf>	<Cyprus>
<2010_Winter_Olympics>	<isLocatedIn>	<Canada>
<Iraq_War>	<isCitizenOf>	<Israel>
<Tomislav_Ivić>	<isCitizenOf>	<France>
<Scott_Loach>	<playsFor>	<Notts_County_F.C.>
<Malaysia>	<isCitizenOf>	<Italy>
<2K_Games>	<isCitizenOf>	<Bulgaria>
<Tom_Cowan>	<isAffiliatedTo>	<Barrow_A.F.C.>
<Simeon_Hodson>	<isAffiliatedTo>	<Lincoln_City_F.C.>
<Citrus_County,_Florida>	<isLocatedIn>	<Florida>
<Tony_Cottee>	<isCitizenOf>	<Martinique>
<Jordan_Parkes>	<isAffiliatedTo>	<Chelmsford_City_F.C.>
<Scott_Barrett_(footballer)>	<isCitizenOf>	<Cyprus>
<Alexander_Payne>	<hasWonPrize>	<Academy_Award_for_Best_Adapted_Screenplay>
<Albano_Bizzarri>	<isAffiliatedTo>	<Delfino_Pescara_1936>
<Habsburg_Monarchy>	<participatedIn>	<War_of_the_Polish_Succession>
<W._E._B._Du_Bois>	<livesIn>	<Georgia_(U.S._state)>
<Scott_Canham>	<isAffiliatedTo>	<Leyton_Orient_F.C.>
<FC_Basel>	<isCitizenOf>	<Panama>
<2017_Romanian_protests>	<happenedIn>	<Glasgow>
<Jonathan_Swift>	<isCitizenOf>	<Austria>
<Neil_Cox_(footballer)>	<isCitizenOf>	<England>
<Eastern_Kentucky_University>	<isCitizenOf>	<Northern_Ireland>
<Maulik_Pancholy>	<isCitizenOf>	<India>
<Colin_West>	<isCitizenOf>	<Scotland>
<Jae_Martin>	<isCitizenOf>	<Sweden>
<Ireland>	<isCitizenOf>	<Italy>
<Duncan_McKenzie>	<isCitizenOf>	<Cape_Verde>
<Road_to_Ultra>	<isLocatedIn>	<Mumbai>
<Charlie_Miller>	<isAffiliatedTo>	<SK_Brann>
<Gus_Uhlenbeek>	<isCitizenOf>	<France>
<Dean_Howell>	<isCitizenOf>	<Bulgaria>
<Andy_Serkis>	<isCitizenOf>	<Netherlands>
<Charles_Rosher>	<isCitizenOf>	<Switzerland>
<Aidan_Davison>	<isAffiliatedTo>	<Sheffield_United_F.C.>
<Aly_Cissokho>	<isAffiliatedTo>	<France_national_football_team>
<Mali>	<isLocatedIn>	<Africa>
<Eric_Wynalda>	<playsFor>	<New_England_Revolution>
<Michigan>	<hasOfficialLanguage>	<English_language>
<Chris_Powell>	<isAffiliatedTo>	<Huddersfield_Town_A.F.C.>
<Richard_Pryor>	<isCitizenOf>	<Monaco>
<Carl_Sagan>	<hasWonPrize>	<Pulitzer_Prize_for_General_Nonfiction>
<Mike_Salmon>	<isAffiliatedTo>	<Bolton_Wanderers_F.C.>
<Robert_Silverberg>	<isCitizenOf>	<Scotland>
<Dave_Martin_(footballer,_born_1963)>	<isCitizenOf>	<Switzerland>
<Kasey_Keller>	<wasBornIn>	<Olympia,_Washington>
<Interscope_Records>	<isLocatedIn>	<United_States>
<Thomas_Brodie-Sangster>	<actedIn>	<Bright_Star_(film)>
<Andrew_Davies_(footballer)>	<isAffiliatedTo>	<Queens_Park_Rangers_F.C.>
<Shirley_Ann_Russell>	<diedIn>	<London>
<Luís_Leal_(footballer)>	<playsFor>	<C.F._Os_Belenenses>
<Ashley_Grimes_(footballer,_born_1957)>	<isCitizenOf>	<China>
<Scott_McDonald>	<isAffiliatedTo>	<A.F.C._Bournemouth>
<Bolt_(2008_film)>	<isCitizenOf>	<Japan>
<Michael_Shannon>	<actedIn>	<Man_of_Steel_(film)>
<Darryl_Flahavan>	<isCitizenOf>	<Martinique>
<Guylain_Ndumbu-Nsungu>	<isCitizenOf>	<Chile>
<Michael_Chabon>	<hasWonPrize>	<Nebula_Award>
<Kiernan_Hughes-Mason>	<isCitizenOf>	<Dominica>
