sentences	sensitiveAttr
<isLocatedIn>Philippines,<isLocatedIn>United_States,	<Israel>
<isLocatedIn>Los_Angeles,	<Cyprus>
<happenedIn>Halifax,_Nova_Scotia,	<England>
<isLocatedIn>Ogden,_Utah,	<Greece>
<isLocatedIn>Canada,	<Iran>
<happenedIn>Cayman_Islands,	<Cameroon>
<happenedIn>Cologne,<happenedIn>Vienna,<happenedIn>Glasgow,	<El_Salvador>
<isLocatedIn>United_States,	<England>
<isLocatedIn>United_States,	<Bulgaria>
<isLocatedIn>United_States,	<Ukraine>
<isLocatedIn>New_York_City,	<Cyprus>
<happenedIn>Dorothy_Chandler_Pavilion,	<Sweden>
<isLocatedIn>Los_Angeles,	<Senegal>
<happenedIn>California,	<Iran>
<happenedIn>Hollywood,	<United_States>
<playsFor>Lincoln_City_F.C.,	<Slovenia>
<wasBornIn>United_States,	<China>
<isAffiliatedTo>Middlesbrough_F.C.,<playsFor>Everton_F.C.,<isAffiliatedTo>PSV_Eindhoven,	<Monaco>
<actedIn>Zombieland,	<Mali>
<isAffiliatedTo>Ipswich_Town_F.C.,	<Netherlands>
<isAffiliatedTo>Bury_F.C.,	<France>
<isAffiliatedTo>Bristol_Rovers_F.C.,	<Brazil>
<isAffiliatedTo>RC_Lens,<isAffiliatedTo>Queens_Park_Rangers_F.C.,	<India>
<playsFor>AZ_Alkmaar,	<Northern_Ireland>
<isAffiliatedTo>Walsall_F.C.,	<Hungary>
<isAffiliatedTo>Sheffield_United_F.C.,	<Russia>
<wasBornIn>Richmond,_Virginia,	<Barbados>
<livesIn>Memphis,_Tennessee,	<Iran>
<isAffiliatedTo>Cheltenham_Town_F.C.,	<Bahrain>
<isAffiliatedTo>Cambridge_United_F.C.,	<United_Arab_Emirates>
<isAffiliatedTo>Nottingham_Forest_F.C.,	<Tanzania>
<isAffiliatedTo>Rotherham_United_F.C.,	<Poland>
<wroteMusicFor>Back_to_the_Future_Part_III,	<Barbados>
<isAffiliatedTo>England_national_football_team,	<Croatia>
<isAffiliatedTo>Delfino_Pescara_1936,	<Republic_of_the_Congo>
<isAffiliatedTo>RCD_Espanyol,	<Italy>
<isAffiliatedTo>C.F._Os_Belenenses,<isAffiliatedTo>Valencia_CF,	<Norway>
<playsFor>Calcio_Catania,	<Switzerland>
<isAffiliatedTo>A.C._Cesena,	<Germany>
<wasBornIn>Highland_Park,_Illinois,	<United_States>
<isAffiliatedTo>Leyton_Orient_F.C.,	<Switzerland>
<graduatedFrom>Yale_University,	<United_States>
<wasBornIn>Kansas_City,_Missouri,	<Wales>
<wasBornIn>Warrington,	<Argentina>
<isAffiliatedTo>ACF_Fiorentina,	<Bangladesh>
<isAffiliatedTo>Notts_County_F.C.,	<France>
<playsFor>Partick_Thistle_F.C.,	<Nigeria>
<isAffiliatedTo>FC_Barcelona,	<Jamaica>
<hasWonPrize>Academy_Award_for_Best_Adapted_Screenplay,	<United_Arab_Emirates>
<isAffiliatedTo>Blackpool_F.C.,	<Australia>
<actedIn>Magnolia_(film),	<Iran>
<isAffiliatedTo>Italy_national_football_team,	<Australia>
<isLocatedIn>Africa,	<Cape_Verde>
<isLocatedIn>United_States,	<Martinique>
<wasBornIn>Bradford,	<Ukraine>
<isAffiliatedTo>Odense_Boldklub,	<Greece>
<isAffiliatedTo>France_national_football_team,	<Northern_Ireland>
<wasBornIn>Wolverhampton,	<Northern_Ireland>
<playsFor>Botafogo_de_Futebol_e_Regatas,	<United_Arab_Emirates>
<livesIn>New_York,	<Bangladesh>
<isLocatedIn>Canada,	<Canada>
<isLocatedIn>North_Holland,	<Iran>
<isLocatedIn>California,	<Monaco>
<diedIn>Neuilly-sur-Seine,	<Croatia>
<isAffiliatedTo>Queens_Park_Rangers_F.C.,	<Bahrain>
<isAffiliatedTo>Charlton_Athletic_F.C.,	<India>
<created>Finding_Nemo,	<Dominica>
<wasBornIn>Dundee,	<Bulgaria>
<isAffiliatedTo>York_City_F.C.,	<United_Kingdom>
<isAffiliatedTo>England_national_football_team,	<Republic_of_the_Congo>
<isAffiliatedTo>Sheffield_United_F.C.,	<Croatia>
<isAffiliatedTo>Leeds_United_F.C.,	<Senegal>
<isAffiliatedTo>Arsenal_F.C.,	<Republic_of_the_Congo>
<isAffiliatedTo>Bolton_Wanderers_F.C.,	<Ukraine>
<playsFor>Southend_United_F.C.,	<Democratic_Republic_of_the_Congo>
<actedIn>Inkheart_(film),	<Netherlands>
<isAffiliatedTo>Oldham_Athletic_A.F.C.,	<Germany>
<hasWonPrize>Laurence_Olivier_Award,	<Germany>
<isLocatedIn>Georgia_(U.S._state),	<Israel>
<isLocatedIn>Cuba,	<Niger>
<isMarriedTo>Mel_Brooks,	<Barbados>
<isLocatedIn>United_Kingdom,	<Wales>
<isLocatedIn>United_Kingdom,	<Slovenia>
<actedIn>Thor_(film),<actedIn>Alexander_(2004_film),	<Bulgaria>
<playsFor>Aldershot_Town_F.C.,	<Australia>
<isAffiliatedTo>Bury_F.C.,	<Poland>
<actedIn>Four_Rooms,	<Mali>
<hasWonPrize>Drama_Desk_Award,	<Democratic_Republic_of_the_Congo>
<isLocatedIn>Virginia,	<El_Salvador>
<isLocatedIn>Los_Angeles_County,_California,	<Japan>
<isLocatedIn>Memphis,_Tennessee,	<Kazakhstan>
<isAffiliatedTo>Newell's_Old_Boys,	<China>
<isLocatedIn>United_States,	<Bangladesh>
<actedIn>American_Gangster_(film),	<Bulgaria>
<dealsWith>Turkey,	<Tanzania>
<isAffiliatedTo>AFC_Ajax,	<Republic_of_the_Congo>
<actedIn>Last_Action_Hero,	<Greece>
<isLocatedIn>Pasadena,_California,	<Monaco>
<wasBornIn>Harlem,	<Puerto_Rico>
<playsFor>Shelbourne_F.C.,	<Slovenia>
<wasBornIn>Livingston,_New_Jersey,	<Bahrain>
<wasBornIn>Mumbai,	<Nigeria>
<isAffiliatedTo>AFC_Wimbledon,	<Croatia>
<isAffiliatedTo>Luton_Town_F.C.,	<China>
<actedIn>Marie_Antoinette_(2006_film),	<Brazil>
<isLocatedIn>United_States,	<Iran>
<isAffiliatedTo>AEK_Athens_F.C.,	<Norway>
<participatedIn>Settling_Accounts,	<France>
<participatedIn>World_War_II,	<Austria>
<isLocatedIn>United_Kingdom,	<Wales>
<isLocatedIn>Towson,_Maryland,	<Tanzania>
<actedIn>Jackass_3D,	<Russia>
<directed>Wag_the_Dog,	<Senegal>
<isAffiliatedTo>Wycombe_Wanderers_F.C.,	<Israel>
<isAffiliatedTo>Middlesbrough_F.C.,	<Kazakhstan>
<isLocatedIn>France,	<Spain>
<isAffiliatedTo>Gillingham_F.C.,<isAffiliatedTo>Bury_F.C.,	<Germany>
<wroteMusicFor>RoboCop,	<Jamaica>
<happenedIn>Netherlands,	<Barbados>
<hasNeighbor>Lithuania,	<Dominica>
<isLocatedIn>Serbia,	<Republic_of_Ireland>
<actedIn>Dogma_(film),	<Dominica>
<wasBornIn>Bradford,	<Scotland>
<isAffiliatedTo>Bristol_City_F.C.,	<Hungary>
<wasBornIn>Sheffield,	<China>
<isAffiliatedTo>Hartlepool_United_F.C.,	<Monaco>
<isAffiliatedTo>Arsenal_F.C.,	<Belgium>
<isAffiliatedTo>Altrincham_F.C.,	<Northern_Ireland>
<isLocatedIn>South_East_England,	<Austria>
<isAffiliatedTo>Chesterfield_F.C.,	<Tanzania>
<isAffiliatedTo>Swindon_Town_F.C.,	<Belgium>
<isAffiliatedTo>Gillingham_F.C.,	<Poland>
<isAffiliatedTo>Huddersfield_Town_A.F.C.,	<Cameroon>
<playsFor>Crewe_Alexandra_F.C.,	<Republic_of_Ireland>
<actedIn>Lucky_Numbers,	<Canada>
<wasBornIn>Lewisham,	<Democratic_Republic_of_the_Congo>
<graduatedFrom>University_of_North_Carolina_at_Chapel_Hill,	<Wales>
<isAffiliatedTo>Nottingham_Forest_F.C.,	<Dominica>
<isAffiliatedTo>Port_Vale_F.C.,	<Tanzania>
<isAffiliatedTo>Grays_Athletic_F.C.,	<Argentina>
<actedIn>The_Believer_(film),	<Wales>
<isLocatedIn>North_West_England,	<Ukraine>
<isAffiliatedTo>Leeds_United_F.C.,<isAffiliatedTo>Colchester_United_F.C.,	<Switzerland>
<directed>All_That_Jazz_(film),	<Puerto_Rico>
<hasWonPrize>Grammy_Award,	<Denmark>
<isAffiliatedTo>Rotherham_United_F.C.,	<Netherlands>
<isAffiliatedTo>Falkirk_F.C.,	<El_Salvador>
<isLocatedIn>Boise,_Idaho,	<Serbia>
<isLocatedIn>United_States,	<Japan>
<hasWonPrize>World_Music_Awards,	<England>
<isAffiliatedTo>Yeovil_Town_F.C.,	<Greece>
<actedIn>A_Bug's_Life,	<Jamaica>
<isAffiliatedTo>United_States_men's_national_soccer_team,	<Slovenia>
<playsFor>Sheffield_Wednesday_F.C.,<playsFor>Bradford_City_A.F.C.,	<Nigeria>
<isAffiliatedTo>Crawley_Town_F.C.,	<England>
<playsFor>New_York_Red_Bulls,	<Puerto_Rico>
<actedIn>The_Village_(2004_film),	<Dominica>
<isAffiliatedTo>Portland_Timbers,	<Sweden>
<isAffiliatedTo>Walsall_F.C.,	<Barbados>
<isAffiliatedTo>Helsingborgs_IF,	<Nigeria>
<isAffiliatedTo>Burton_Albion_F.C.,	<Bangladesh>
<isAffiliatedTo>Bolton_Wanderers_F.C.,	<Italy>
<isAffiliatedTo>Nottingham_Forest_F.C.,	<Cameroon>
<isAffiliatedTo>Shrewsbury_Town_F.C.,	<Australia>
<isLocatedIn>United_States,	<Croatia>
<isLocatedIn>Vancouver,	<Israel>
<actedIn>Swept_Away_(2002_film),	<Bangladesh>
<isAffiliatedTo>Villarreal_CF,	<El_Salvador>
<isAffiliatedTo>AS_Monaco_FC,	<Russia>
<isLocatedIn>Zimbabwe,	<Russia>
<hasWonPrize>Venice_Film_Festival,	<England>
<hasOfficialLanguage>Latin,	<Kazakhstan>
<isAffiliatedTo>Panathinaikos_F.C.,	<Brazil>
<isLocatedIn>United_States,	<Scotland>
<participatedIn>Operation_Ocean_Shield,	<Puerto_Rico>
<isLocatedIn>New_Jersey,	<Germany>
<playsFor>Stockport_County_F.C.,	<Scotland>
<isAffiliatedTo>Manchester_City_F.C.,	<India>
<playsFor>Watford_F.C.,	<Canada>
<hasWonPrize>Pulitzer_Prize_for_General_Nonfiction,	<Italy>
<isAffiliatedTo>Wolverhampton_Wanderers_F.C.,	<Democratic_Republic_of_the_Congo>
<isAffiliatedTo>Rangers_F.C.,	<Niger>
<playsFor>D.C._United,	<Nigeria>
<wasBornIn>Mexico_City,	<Chile>
<isAffiliatedTo>A.S._Livorno_Calcio,	<United_Arab_Emirates>
<hasWonPrize>Primetime_Emmy_Award,	<United_States>
<wroteMusicFor>Velvet_Goldmine,	<El_Salvador>
<isLocatedIn>Tunisia,	<Nigeria>
<created>Sunset_Boulevard_(film),	<Iran>
<worksAt>University_of_Cambridge,	<Sweden>
<diedIn>Lisbon,	<Switzerland>
<isAffiliatedTo>SK_Brann,	<Scotland>
<wasBornIn>New_York_City,	<Nigeria>
<isLocatedIn>Chicago_metropolitan_area,	<Nigeria>
<isLocatedIn>Elgin,_Illinois,<isLocatedIn>Evanston,_Illinois,	<Kazakhstan>
<isLocatedIn>Tokyo,	<Australia>
<isAffiliatedTo>Stockport_County_F.C.,	<Cyprus>
<playsFor>AFC_Wimbledon,	<Bulgaria>
<actedIn>Capote_(film),	<Poland>
<playsFor>Australia_national_soccer_team,	<United_Kingdom>
<wasBornIn>Newcastle_upon_Tyne,	<Russia>
<isAffiliatedTo>Watford_F.C.,	<Democratic_Republic_of_the_Congo>
<isAffiliatedTo>Heart_of_Midlothian_F.C.,	<Panama>
<playsFor>Wrexham_A.F.C.,	<France>
<isAffiliatedTo>Reading_F.C.,	<Canada>
<isAffiliatedTo>Tamworth_F.C.,	<Switzerland>
<isAffiliatedTo>Huddersfield_Town_A.F.C.,	<Russia>
<isAffiliatedTo>Edmonton_Oilers,	<Canada>
<wasBornIn>Liverpool,	<England>
<isAffiliatedTo>Hertha_BSC,	<Netherlands>
<wasBornIn>Middlesbrough,	<Bulgaria>
<wasBornIn>New_York_City,	<Puerto_Rico>
<isLocatedIn>Florida,	<Monaco>
<isAffiliatedTo>Derby_County_F.C.,	<Bulgaria>
<hasWonPrize>Donaldson_Awards,	<Niger>
<directed>Hereafter_(film),<directed>Million_Dollar_Baby,	<Russia>
<playsFor>Queens_Park_Rangers_F.C.,	<Australia>
<isAffiliatedTo>Colchester_United_F.C.,	<England>
<influences>Alan_Moore,	<France>
<isAffiliatedTo>FC_Groningen,<playsFor>Darlington_F.C.,	<Senegal>
<isLocatedIn>Coimbatore_district,	<Germany>
<isAffiliatedTo>Bristol_City_F.C.,	<Scotland>
<playsFor>Leicester_City_F.C.,	<Slovenia>
<isAffiliatedTo>Blackpool_F.C.,	<Martinique>
<actedIn>Pearl_Harbor_(film),	<Poland>
<hasOfficialLanguage>Spanish_language,	<Brazil>
<isLocatedIn>South_Carolina,	<Brazil>
<isLocatedIn>New_York,	<Barbados>
<isLocatedIn>Manhattan,	<Japan>
<isLocatedIn>New_Hampshire,	<United_Kingdom>
<participatedIn>American_Civil_War,	<Kazakhstan>
<playsFor>Ipswich_Town_F.C.,	<Democratic_Republic_of_the_Congo>
<isLocatedIn>Denmark,	<Austria>
<dealsWith>Mexico,	<Norway>
<wasBornIn>Paddington,	<Bahrain>
<isAffiliatedTo>Blackpool_F.C.,	<Cameroon>
<isAffiliatedTo>Brighton_&_Hove_Albion_F.C.,	<Argentina>
<playsFor>Notts_County_F.C.,	<Cameroon>
<isAffiliatedTo>Luton_Town_F.C.,	<Kazakhstan>
<wasBornIn>Chicago,	<United_States>
<isAffiliatedTo>Oldham_Athletic_A.F.C.,	<Mali>
<isAffiliatedTo>Italy_national_football_team,	<Sweden>
<isAffiliatedTo>Club_Olimpia,	<Brazil>
<isAffiliatedTo>A.C._ChievoVerona,	<Cameroon>
<isLocatedIn>Texas,	<Canada>
<isAffiliatedTo>A.S._Livorno_Calcio,	<Canada>
<wasBornIn>Teaneck,_New_Jersey,	<Scotland>
<playsFor>Boca_Juniors,	<Cyprus>
<wasBornIn>Honolulu,<hasWonPrize>Medal_of_Honor,	<Northern_Ireland>
<isAffiliatedTo>Notts_County_F.C.,	<France>
<isAffiliatedTo>West_Ham_United_F.C.,	<Northern_Ireland>
<isAffiliatedTo>Plymouth_Argyle_F.C.,<isAffiliatedTo>Bury_F.C.,	<Martinique>
<playsFor>Macclesfield_Town_F.C.,	<Cape_Verde>
<isAffiliatedTo>Middlesbrough_F.C.,	<Puerto_Rico>
<isAffiliatedTo>Brighton_&_Hove_Albion_F.C.,	<United_Arab_Emirates>
<wroteMusicFor>A_Simple_Plan_(film),<wroteMusicFor>Restless_(2011_film),	<Bangladesh>
<isAffiliatedTo>Blackpool_F.C.,	<Slovenia>
<isAffiliatedTo>Norwich_City_F.C.,	<Slovenia>
<isAffiliatedTo>Bristol_City_F.C.,	<Germany>
<isAffiliatedTo>Grays_Athletic_F.C.,	<Niger>
<isLocatedIn>Croatia,	<El_Salvador>
<isAffiliatedTo>Mansfield_Town_F.C.,<playsFor>Coventry_City_F.C.,	<England>
<isAffiliatedTo>SC_Heerenveen,	<Republic_of_the_Congo>
<isAffiliatedTo>Millwall_F.C.,<isAffiliatedTo>Bristol_City_F.C.,	<Hungary>
<isAffiliatedTo>Crystal_Palace_F.C.,	<Martinique>
<hasWonPrize>Grammy_Award,	<France>
<isAffiliatedTo>Welling_United_F.C.,	<El_Salvador>
<diedIn>Nottingham,	<Scotland>
<isAffiliatedTo>Leyton_Orient_F.C.,	<Switzerland>
<playsFor>Woking_F.C.,	<Australia>
<playsFor>Hull_City_A.F.C.,	<Republic_of_Ireland>
<isAffiliatedTo>England_national_football_team,	<Jamaica>
<playsFor>Bradford_City_A.F.C.,	<Austria>
<isAffiliatedTo>Darlington_F.C.,	<Sweden>
<isAffiliatedTo>Wimbledon_F.C.,	<Cape_Verde>
<isAffiliatedTo>Dundee_United_F.C.,	<Martinique>
<wasBornIn>Manhattan,	<Martinique>
<actedIn>The_Hunchback_of_Notre_Dame_(1996_film),	<Netherlands>
<actedIn>Anonymous_(film),	<Ukraine>
<playsFor>A.C._Milan,<playsFor>Spezia_Calcio,	<Bulgaria>
<isAffiliatedTo>Colchester_United_F.C.,	<Scotland>
<isAffiliatedTo>Port_Vale_F.C.,	<Panama>
<isAffiliatedTo>Notts_County_F.C.,	<Bulgaria>
<playsFor>Ipswich_Town_F.C.,	<Norway>
<isAffiliatedTo>Luton_Town_F.C.,	<Denmark>
<isAffiliatedTo>Oxford_United_F.C.,	<Australia>
<isAffiliatedTo>Bristol_City_F.C.,<playsFor>Rochdale_A.F.C.,	<Puerto_Rico>
<dealsWith>United_States,<participatedIn>Kosovo_War,	<Ukraine>
<isAffiliatedTo>Birmingham_City_F.C.,	<Belgium>
<isAffiliatedTo>Chester_City_F.C.,	<Panama>
<isLocatedIn>Denver,	<Serbia>
<hasWonPrize>Tony_Award,	<Scotland>
<isAffiliatedTo>Dundee_United_F.C.,	<United_Kingdom>
<isAffiliatedTo>West_Bromwich_Albion_F.C.,	<India>
<wasBornIn>New_Westminster,	<Puerto_Rico>
<actedIn>Casting_By,	<Greece>
<hasWonPrize>APRA_Awards_(Australia),	<Germany>
<isAffiliatedTo>Club_Olimpia,	<Panama>
<isAffiliatedTo>Inter_Milan,	<Poland>
<isAffiliatedTo>CS_Sedan_Ardennes,	<Poland>
<isAffiliatedTo>S.S._Lazio,	<Nigeria>
<isAffiliatedTo>Plymouth_Argyle_F.C.,	<Kazakhstan>
<actedIn>Hannibal_Rising_(film),<livesIn>Hammersmith,	<Argentina>
<hasOfficialLanguage>Spanish_language,	<Barbados>
<diedIn>Los_Angeles,	<Republic_of_Ireland>
<playsFor>Leicester_City_F.C.,	<France>
<isAffiliatedTo>Altrincham_F.C.,	<Jamaica>
<isAffiliatedTo>Shelbourne_F.C.,	<Croatia>
<hasWonPrize>Grammy_Award,<wasBornIn>Boston,	<Democratic_Republic_of_the_Congo>
<diedIn>New_York_City,	<Switzerland>
<isAffiliatedTo>Southend_United_F.C.,	<England>
<wasBornIn>Cambridge,	<England>
<isLocatedIn>Netherlands,	<Republic_of_Ireland>
<isAffiliatedTo>Everton_F.C.,	<Cape_Verde>
<isLocatedIn>Guangzhou,	<Serbia>
<isLocatedIn>Kentucky,	<Northern_Ireland>
<isLocatedIn>Barcelona–El_Prat_Airport,	<United_Kingdom>
<actedIn>Rich_Man,_Poor_Man_(miniseries),	<Croatia>
<actedIn>The_Hangover,	<Democratic_Republic_of_the_Congo>
<actedIn>The_Adventures_of_Ford_Fairlane,	<Kazakhstan>
<wasBornIn>Rock_Island,_Illinois,	<Israel>
<isAffiliatedTo>Republic_of_Ireland_national_football_team,	<Democratic_Republic_of_the_Congo>
<influences>Peter_David,	<Russia>
<isLocatedIn>Edmonton,	<Brazil>
<graduatedFrom>Leipzig_University,	<Wales>
<actedIn>The_Ten_Commandments_(1956_film),	<China>
<actedIn>The_Illusionist_(2006_film),	<China>
<wasBornIn>Jerusalem,	<Mali>
<wasBornIn>London,	<Japan>
<directed>The_Last_Samurai,	<Dominica>
<playsFor>Molde_FK,	<England>
<dealsWith>China,	<India>
<isLocatedIn>Dallas,<isLocatedIn>Las_Vegas,	<Japan>
<actedIn>The_Holiday,	<Hungary>
<directed>On_the_Waterfront,	<Dominica>
<graduatedFrom>University_of_Pennsylvania,	<Greece>
<wasBornIn>Evanston,_Illinois,	<Democratic_Republic_of_the_Congo>
<isMarriedTo>Richard_Burton,	<England>
<wroteMusicFor>Frida,	<Cape_Verde>
<isAffiliatedTo>Ternana_Calcio,	<Bahrain>
<isAffiliatedTo>Brazil_national_football_team,	<Democratic_Republic_of_the_Congo>
<isAffiliatedTo>Derby_County_F.C.,	<China>
<actedIn>Milk_(film),	<Senegal>
<wasBornIn>St._Joseph,_Missouri,	<Tanzania>
<actedIn>Angels_in_America_(miniseries),	<China>
<isLocatedIn>United_States,	<Iran>
<happenedIn>Kingdom_of_England,	<Martinique>
<worksAt>Columbia_University,	<United_States>
<isLocatedIn>Los_Angeles,	<India>
<isLocatedIn>Surrey,	<Switzerland>
<hasOfficialLanguage>Spanish_language,	<Ukraine>
<playsFor>Kidderminster_Harriers_F.C.,	<Russia>
<isAffiliatedTo>Atlanta_Silverbacks,<playsFor>New_England_Revolution,	<Spain>
<participatedIn>Operation_Enduring_Freedom_–_Horn_of_Africa,	<Wales>
<isAffiliatedTo>Fulham_F.C.,	<Kazakhstan>
<wasBornIn>Buenos_Aires,	<Northern_Ireland>
<hasWonPrize>Grammy_Award,	<Austria>
<actedIn>The_Wrestler_(2008_film),	<Poland>
<isLocatedIn>Basel,	<Panama>
<isLocatedIn>Russia,	<Wales>
<directed>La_Dolce_Vita,	<Sweden>
<isAffiliatedTo>Panathinaikos_F.C.,	<Greece>
<actedIn>Nine_(2009_live-action_film),	<Ukraine>
<isAffiliatedTo>Hull_City_A.F.C.,	<England>
<participatedIn>International_Force_for_East_Timor,	<Iran>
<diedIn>Los_Angeles,	<Denmark>
<hasWonPrize>Drama_Desk_Award,<actedIn>Short_Cuts_(film),	<Nigeria>
<isAffiliatedTo>Leeds_United_F.C.,	<Republic_of_the_Congo>
<playsFor>Fulham_F.C.,	<El_Salvador>
<isAffiliatedTo>Leeds_United_F.C.,	<United_Kingdom>
<isAffiliatedTo>Woking_F.C.,	<Greece>
<actedIn>From_Dusk_till_Dawn,	<Hungary>
<isAffiliatedTo>Grays_Athletic_F.C.,	<Puerto_Rico>
<isLocatedIn>Fresno,_California,	<El_Salvador>
<isLocatedIn>United_States,	<United_States>
<livesIn>British_Columbia,	<Hungary>
<isAffiliatedTo>AFC_Wimbledon,	<Croatia>
<playsFor>Sheffield_United_F.C.,	<England>
<isAffiliatedTo>Birmingham_City_F.C.,	<Republic_of_the_Congo>
<isAffiliatedTo>Gillingham_F.C.,	<Barbados>
<isAffiliatedTo>Walsall_F.C.,	<Cameroon>
<playsFor>Grays_Athletic_F.C.,	<China>
<isAffiliatedTo>Arsenal_F.C.,	<Poland>
<playsFor>Hereford_United_F.C.,	<Dominica>
<playsFor>Hednesford_Town_F.C.,	<Serbia>
<isLocatedIn>Fairfax_County,_Virginia,	<Austria>
<isLocatedIn>Fairfield,_Connecticut,	<Serbia>
<isAffiliatedTo>Leicester_City_F.C.,	<Israel>
<isAffiliatedTo>Cambridge_United_F.C.,	<Northern_Ireland>
<playsFor>Rochdale_A.F.C.,<isAffiliatedTo>Crewe_Alexandra_F.C.,	<Serbia>
<influences>Fredric_Jameson,	<Belgium>
<isAffiliatedTo>Stoke_City_F.C.,	<Netherlands>
<influences>Whoopi_Goldberg,<wasBornIn>New_York_City,	<Israel>
<actedIn>The_Godfather_Part_III,	<Mali>
<playsFor>Brentford_F.C.,	<Serbia>
<graduatedFrom>University_of_Southern_California,	<Sweden>
<directed>A_Place_in_the_Sun_(film),	<Republic_of_the_Congo>
<wasBornIn>New_Haven,_Connecticut,	<Republic_of_Ireland>
<isAffiliatedTo>VfL_Bochum,	<Australia>
<diedIn>Neuilly-sur-Seine,	<Iran>
<hasOfficialLanguage>English_language,	<Israel>
<wasBornIn>Independence,_Missouri,	<Kazakhstan>
<isAffiliatedTo>Tottenham_Hotspur_F.C.,	<Republic_of_the_Congo>
<isAffiliatedTo>SC_Bastia,	<Martinique>
<isLocatedIn>United_States,	<El_Salvador>
<isAffiliatedTo>U.C._Sampdoria,	<Hungary>
<playsFor>Eastleigh_F.C.,	<Serbia>
<isAffiliatedTo>Derby_County_F.C.,	<Niger>
<hasWonPrize>Grammy_Award,<actedIn>The_Green_Mile_(film),	<Jamaica>
<playsFor>Walsall_F.C.,	<Serbia>
<playsFor>Stoke_City_F.C.,<playsFor>West_Bromwich_Albion_F.C.,<wasBornIn>Solihull,<playsFor>Birmingham_City_F.C.,	<Belgium>
<isAffiliatedTo>West_Bromwich_Albion_F.C.,	<Puerto_Rico>
<isLocatedIn>Michigan,	<Mali>
<isLocatedIn>United_States,	<Austria>
<isLocatedIn>Ontario,	<Austria>
<participatedIn>Nicaraguan_Revolution,	<Scotland>
<isLocatedIn>United_States,	<Monaco>
<playsFor>Cardiff_City_F.C.,	<Serbia>
<playsFor>Kidderminster_Harriers_F.C.,	<Australia>
<isAffiliatedTo>Celtic_F.C.,	<Russia>
<isAffiliatedTo>Macclesfield_Town_F.C.,	<Cameroon>
<influences>Brendon_Small,	<Puerto_Rico>
<isAffiliatedTo>Legia_Warsaw,	<Cameroon>
<isAffiliatedTo>Forfar_Athletic_F.C.,	<Senegal>
<participatedIn>Northern_Mali_conflict,	<Cape_Verde>
<playsFor>Mansfield_Town_F.C.,	<France>
<influences>George_Orwell,	<France>
<isAffiliatedTo>Rotherham_United_F.C.,<playsFor>Lincoln_City_F.C.,	<Chile>
<isAffiliatedTo>Darlington_F.C.,	<Chile>
<isAffiliatedTo>Clube_de_Regatas_do_Flamengo,	<Kazakhstan>
<participatedIn>War_of_the_Polish_Succession,	<Republic_of_Ireland>
<isLocatedIn>United_States,	<Italy>
<wroteMusicFor>The_Da_Vinci_Code_(film),	<United_Arab_Emirates>
<hasWonPrize>Jean_Hersholt_Humanitarian_Award,	<Switzerland>
<wroteMusicFor>Kingdom_of_Heaven_(film),	<Brazil>
<wasBornIn>Barrow-in-Furness,	<Australia>
<wasBornIn>Brooklyn,	<Austria>
<isLocatedIn>Hartford,_Connecticut,	<Croatia>
<created>The_Weinstein_Company,	<Serbia>
<playsFor>Olympiakos_Nicosia,	<Croatia>
<isAffiliatedTo>Nottingham_Forest_F.C.,	<Martinique>
<wasBornIn>United_States,	<Democratic_Republic_of_the_Congo>
<isLocatedIn>Nashua,_New_Hampshire,	<Argentina>
<wasBornIn>Mumbai,	<Sweden>
<playsFor>Norwich_City_F.C.,	<Nigeria>
<hasWonPrize>Primetime_Emmy_Award_for_Outstanding_Writing_for_a_Drama_Series,	<Canada>
<wroteMusicFor>The_Lord_of_the_Rings_(film_series),	<Scotland>
<actedIn>Arthur_Christmas,	<China>
<actedIn>The_Matrix,	<United_Kingdom>
<isLocatedIn>New_York_metropolitan_area,	<Bulgaria>
<isLocatedIn>United_States,	<Iran>
<playsFor>Genoa_C.F.C.,	<Canada>
<isAffiliatedTo>Everton_F.C.,	<Croatia>
<isAffiliatedTo>Leeds_United_F.C.,	<Canada>
<isAffiliatedTo>Northampton_Town_F.C.,	<Germany>
<livesIn>Palm_Springs,_California,	<Russia>
<isAffiliatedTo>Birmingham_City_F.C.,	<Argentina>
<wasBornIn>Perth,_Scotland,	<Canada>
<isAffiliatedTo>Wrexham_A.F.C.,	<Wales>
<isAffiliatedTo>FC_Metalurh_Zaporizhya,	<United_Arab_Emirates>
<isLocatedIn>Florida,<isLocatedIn>Canada,	<Greece>
<participatedIn>Operation_Enduring_Freedom_–_Horn_of_Africa,<hasCurrency>Indian_rupee,	<Norway>
<isLocatedIn>Bangladesh,	<Republic_of_Ireland>
<isLocatedIn>Tyrol_(state),	<Mali>
<isLocatedIn>California,	<Poland>
<isLocatedIn>United_States,	<Kazakhstan>
<isLocatedIn>South_Island,	<Bahrain>
<isLocatedIn>California,	<Cameroon>
<dealsWith>Greece,	<Kazakhstan>
<happenedIn>Iraq,	<Israel>
<participatedIn>United_Nations_Operation_in_Somalia_II,	<Italy>
<wasBornIn>Houston,	<Bangladesh>
<isAffiliatedTo>SBV_Vitesse,	<Poland>
<participatedIn>Lebanese_Civil_War,	<France>
<dealsWith>China,	<Bulgaria>
<isAffiliatedTo>Wrexham_A.F.C.,	<Argentina>
<actedIn>A_Few_Good_Men,<actedIn>Easy_Rider,	<Argentina>
<actedIn>Bulworth,	<Tanzania>
<influences>Edward_Said,	<Democratic_Republic_of_the_Congo>
<isAffiliatedTo>Lincoln_City_F.C.,	<Sweden>
<isAffiliatedTo>Clube_de_Regatas_do_Flamengo,	<England>
<wasBornIn>Manchester,	<Sweden>
<dealsWith>Canada,	<Norway>
<hasWonPrize>Brit_Awards,	<Iran>
<isAffiliatedTo>Wimbledon_F.C.,<isAffiliatedTo>Nottingham_Forest_F.C.,	<Panama>
<wasBornIn>London,	<United_Kingdom>
<created>Willow_(film),	<Senegal>
<wasBornIn>Akron,_Ohio,	<Croatia>
<hasWonPrize>Writers_Guild_of_America_Award,	<Greece>
<actedIn>Julius_Caesar_(1953_film),	<Poland>
<wroteMusicFor>Mumford_(film),<wroteMusicFor>The_Bourne_Legacy_(film),	<Cameroon>
<playsFor>Walsall_F.C.,	<Italy>
<actedIn>The_Adventures_of_Pluto_Nash,	<Croatia>
<isAffiliatedTo>Sheffield_Wednesday_F.C.,	<Italy>
<wasBornIn>Liverpool,	<Bahrain>
<actedIn>Once_Upon_a_Time_in_America,	<Cameroon>
<isAffiliatedTo>Ebbsfleet_United_F.C.,	<Cameroon>
<wasBornIn>Ames,_Iowa,	<Austria>
<actedIn>Role_Models,	<United_Arab_Emirates>
<hasCurrency>Japanese_yen,	<Kazakhstan>
<isAffiliatedTo>Milton_Keynes_Dons_F.C.,	<Republic_of_Ireland>
<actedIn>From_Hell_(film),	<Bahrain>
<isAffiliatedTo>Crystal_Palace_F.C.,	<Australia>
<isAffiliatedTo>Phoenix_Suns,	<Bangladesh>
<isAffiliatedTo>Nottingham_Forest_F.C.,	<Chile>
<isAffiliatedTo>Millwall_F.C.,	<Canada>
<wasBornIn>Montpellier,	<Serbia>
<isAffiliatedTo>Northampton_Town_F.C.,	<Spain>
<playsFor>Northwich_Victoria_F.C.,	<Japan>
<wasBornIn>Buffalo,_New_York,	<Slovenia>
<isAffiliatedTo>Bristol_Rovers_F.C.,	<Bulgaria>
<livesIn>Brooklyn,	<England>
<isAffiliatedTo>Wigan_Athletic_F.C.,	<Spain>
<wasBornIn>Cleveland,	<Kazakhstan>
<wasBornIn>Southampton,	<Jamaica>
<playsFor>Hamilton_Academical_F.C.,	<Panama>
<isAffiliatedTo>Southampton_F.C.,	<El_Salvador>
<isAffiliatedTo>Notts_County_F.C.,	<Hungary>
<diedIn>Kensington,	<Republic_of_the_Congo>
<hasWonPrize>Grammy_Award,	<Russia>
<isAffiliatedTo>Everton_F.C.,	<United_Arab_Emirates>
<isAffiliatedTo>Swindon_Town_F.C.,	<Iran>
<isAffiliatedTo>Coventry_City_F.C.,	<China>
<playsFor>Hereford_United_F.C.,	<Denmark>
<playsFor>Peterborough_United_F.C.,	<Switzerland>
<isAffiliatedTo>Cambridge_United_F.C.,	<Wales>
<actedIn>The_Master_(2012_film),	<Bulgaria>
<isAffiliatedTo>Watford_F.C.,	<India>
<isAffiliatedTo>Fulham_F.C.,	<Jamaica>
<isAffiliatedTo>Blackburn_Rovers_F.C.,	<England>
<wasBornIn>Grimsby,	<Russia>
<wasBornIn>Austria-Hungary,	<Italy>
<isAffiliatedTo>Rochdale_A.F.C.,	<Poland>
<influences>Georg_Wilhelm_Friedrich_Hegel,	<Ukraine>
<isAffiliatedTo>Watford_F.C.,	<United_States>
<playsFor>Manchester_City_F.C.,	<Denmark>
<isAffiliatedTo>Barnsley_F.C.,	<Austria>
<isAffiliatedTo>Coventry_City_F.C.,	<Tanzania>
<actedIn>The_Quiet_Man,	<Switzerland>
<isAffiliatedTo>Celtic_F.C.,<isAffiliatedTo>Manchester_City_F.C.,	<Panama>
<isAffiliatedTo>Swansea_City_A.F.C.,	<Kazakhstan>
<isAffiliatedTo>Chester_City_F.C.,	<Northern_Ireland>
<isAffiliatedTo>Manchester_United_F.C.,	<France>
<actedIn>The_Man_in_the_Iron_Mask_(1998_film),	<Cameroon>
<playsFor>Swansea_City_A.F.C.,	<Barbados>
<actedIn>Evan_Almighty,<actedIn>For_Your_Consideration_(film),<actedIn>A_Mighty_Wind,	<Belgium>
<isAffiliatedTo>West_Ham_United_F.C.,	<Cyprus>
<graduatedFrom>Massachusetts_Institute_of_Technology,	<Belgium>
<isAffiliatedTo>Arsenal_F.C.,	<India>
<isAffiliatedTo>Crewe_Alexandra_F.C.,	<Hungary>
<isAffiliatedTo>Rotherham_United_F.C.,	<Cyprus>
<playsFor>Tottenham_Hotspur_F.C.,	<Republic_of_the_Congo>
<wasBornIn>Birmingham,	<Iran>
<isAffiliatedTo>Kidderminster_Harriers_F.C.,	<Greece>
<isAffiliatedTo>Roda_JC_Kerkrade,	<Sweden>
<isAffiliatedTo>Preston_North_End_F.C.,	<Tanzania>
<isAffiliatedTo>Crewe_Alexandra_F.C.,	<Martinique>
<playsFor>Cardiff_City_F.C.,	<Germany>
<isAffiliatedTo>Mansfield_Town_F.C.,	<Norway>
<isAffiliatedTo>Norwich_City_F.C.,	<United_States>
<graduatedFrom>Trinity_College,_Dublin,	<Austria>
<hasWonPrize>Grammy_Lifetime_Achievement_Award,	<Canada>
<isAffiliatedTo>Peterborough_United_F.C.,	<Norway>
<isAffiliatedTo>Chelmsford_City_F.C.,	<Serbia>
<playsFor>A.F.C._Telford_United,	<Austria>
<isInterestedIn>Georg_Wilhelm_Friedrich_Hegel,	<Martinique>
<isAffiliatedTo>Charlton_Athletic_F.C.,	<France>
<isAffiliatedTo>Argentina_national_football_team,	<Puerto_Rico>
<actedIn>My_Week_with_Marilyn,	<Martinique>
<graduatedFrom>Columbia_University,	<Italy>
<playsFor>Northampton_Town_F.C.,	<France>
<isAffiliatedTo>Coventry_City_F.C.,	<Bangladesh>
<isAffiliatedTo>Canada_men's_national_soccer_team,	<Mali>
<isAffiliatedTo>Eintracht_Frankfurt,	<El_Salvador>
<wasBornIn>Springfield,_Ohio,	<Ukraine>
<hasWonPrize>Filmfare_Awards_South,	<Chile>
<isAffiliatedTo>FC_Istres,<isAffiliatedTo>Le_Havre_AC,	<Canada>
<isAffiliatedTo>Vicenza_Calcio,<isAffiliatedTo>A.C._Milan,	<Martinique>
<isLocatedIn>Ghent,	<Republic_of_Ireland>
<hasWonPrize>Nobel_Prize_in_Physiology_or_Medicine,	<France>
<isAffiliatedTo>Stade_Rennais_F.C.,	<Jamaica>
<isLocatedIn>British_Columbia,	<Bangladesh>
<isLocatedIn>Jackson_County,_Missouri,	<Puerto_Rico>
<directed>My_Name_Is_Khan,	<Norway>
<livesIn>Los_Angeles,	<Monaco>
<wasBornIn>The_Hague,	<Argentina>
<isAffiliatedTo>Farnborough_F.C.,	<United_States>
<wasBornIn>Olympia,_Washington,	<France>
<dealsWith>Germany,	<Northern_Ireland>
<isAffiliatedTo>Sierra_Leone_national_football_team,	<Serbia>
<isAffiliatedTo>Birmingham_City_F.C.,	<England>
<isAffiliatedTo>Stockport_County_F.C.,	<Wales>
<isAffiliatedTo>Coventry_City_F.C.,	<Germany>
<actedIn>Jerry_Maguire,	<Northern_Ireland>
<isAffiliatedTo>Preston_North_End_F.C.,	<Cameroon>
<isAffiliatedTo>Leeds_United_F.C.,	<Niger>
<wasBornIn>Baltimore,	<Germany>
<participatedIn>Operation_Enduring_Freedom,	<Tanzania>
<isAffiliatedTo>Leyton_Orient_F.C.,	<Iran>
<playsFor>Brentford_F.C.,	<Wales>
<graduatedFrom>University_of_Minnesota,	<Brazil>
<isAffiliatedTo>Everton_F.C.,	<El_Salvador>
<isAffiliatedTo>Aston_Villa_F.C.,	<Israel>
<created>Jersey_Girl_(2004_film),	<Japan>
<actedIn>L.A._Confidential_(film),	<China>
<playsFor>Cardiff_City_F.C.,	<Niger>
<isAffiliatedTo>Luton_Town_F.C.,	<Senegal>
<isLocatedIn>Cincinnati,	<Iran>
<hasCapital>Naples,	<Martinique>
<participatedIn>Operation_Barbarossa,	<Chile>
<isLocatedIn>East_Riding_of_Yorkshire,	<Hungary>
<diedIn>Tokyo,	<Germany>
<wroteMusicFor>TMNT_(film),	<Croatia>
<isLocatedIn>Kanagawa_Prefecture,	<Senegal>
<isLocatedIn>Ghana,	<England>
<participatedIn>Gulf_War,	<Spain>
<actedIn>The_Flintstones_(film),	<Cameroon>
<isLocatedIn>Erie,_Pennsylvania,	<Bulgaria>
<actedIn>Ray_(film),	<Croatia>
<diedIn>Los_Angeles,	<Germany>
<isLocatedIn>United_States,	<Jamaica>
<playsFor>Crawley_Town_F.C.,	<Niger>
<hasNeighbor>Lithuania,	<Puerto_Rico>
<actedIn>The_Mirror_Has_Two_Faces,	<Poland>
<isAffiliatedTo>Levante_UD,	<China>
<isLocatedIn>United_States,	<Bulgaria>
<directed>Wyatt_Earp_(film),	<Cameroon>
<playsFor>Southend_United_F.C.,	<Italy>
<isAffiliatedTo>Kidderminster_Harriers_F.C.,<isAffiliatedTo>Oxford_United_F.C.,	<Bulgaria>
<isAffiliatedTo>South_Korea_national_football_team,	<Hungary>
<isAffiliatedTo>Portsmouth_F.C.,	<Northern_Ireland>
<actedIn>The_Exorcist_(film),	<Russia>
<isAffiliatedTo>Cambridge_United_F.C.,	<Iran>
<isAffiliatedTo>Hereford_United_F.C.,	<Bahrain>
<wasBornIn>Liverpool,	<Spain>
<isAffiliatedTo>Brentford_F.C.,	<Martinique>
<isLocatedIn>United_Kingdom,	<Sweden>
<wasBornIn>Fort_Worth,_Texas,	<Puerto_Rico>
<actedIn>Star_Trek_(film),	<Jamaica>
<wasBornIn>Sheffield,	<Scotland>
<playsFor>Middlesbrough_F.C.,	<United_Arab_Emirates>
<playsFor>Tottenham_Hotspur_F.C.,	<Senegal>
<isLocatedIn>Anguilla,	<Serbia>
<playsFor>Newcastle_United_F.C.,	<Canada>
<isAffiliatedTo>Wigan_Athletic_F.C.,	<Hungary>
<playsFor>A.F.C._Telford_United,	<Germany>
<playsFor>Bury_F.C.,	<Bangladesh>
<isAffiliatedTo>Brisbane_Roar_FC,	<Spain>
<hasNeighbor>Tunisia,	<Kazakhstan>
<playsFor>Plymouth_Argyle_F.C.,	<China>
<isLocatedIn>United_States,	<El_Salvador>
<actedIn>And_the_Band_Played_On_(film),	<Russia>
<isLocatedIn>Lincoln,_England,	<Senegal>
<actedIn>Super_(2010_American_film),	<Belgium>
<actedIn>I_Know_Who_Killed_Me,	<Canada>
<playsFor>Peterborough_United_F.C.,	<Puerto_Rico>
<isAffiliatedTo>Portsmouth_F.C.,	<England>
<happenedIn>Czech_Republic,	<Senegal>
<isLocatedIn>Greater_Los_Angeles_Area,	<Kazakhstan>
<wroteMusicFor>Spy_Kids,	<Italy>
<playsFor>Ebbsfleet_United_F.C.,	<Slovenia>
<wasBornIn>Paris,	<Austria>
<playsFor>Olympique_Lyonnais,<isAffiliatedTo>Olympique_Lyonnais,	<Poland>
<wasBornIn>Paris,	<Nigeria>
<isAffiliatedTo>Tiburones_Rojos_de_Veracruz,	<France>
<playsFor>Genoa_C.F.C.,	<Serbia>
<created>Burning_Bridges_(Ludacris_EP),	<United_States>
<influences>Isaiah_Berlin,<diedIn>Cambridge,	<Nigeria>
<isLocatedIn>Nazi_Germany,	<Northern_Ireland>
<playsFor>A.C._Milan,	<Iran>
<isAffiliatedTo>Monarcas_Morelia,	<Barbados>
<playsFor>C.F._Os_Belenenses,	<Israel>
<directed>The_Last_Airbender,	<Wales>
<isLocatedIn>Minnesota,	<Northern_Ireland>
<hasWonPrize>Tony_Award,	<China>
<playsFor>FC_Dallas,	<Chile>
<participatedIn>United_Nations_Operation_in_Somalia_II,	<Italy>
<isLocatedIn>Africa,	<France>
<participatedIn>Italian_Campaign_(World_War_II),	<Senegal>
<isAffiliatedTo>Partick_Thistle_F.C.,	<Serbia>
<isAffiliatedTo>Delfino_Pescara_1936,<isAffiliatedTo>Udinese_Calcio,	<Panama>
<playsFor>Watford_F.C.,	<Chile>
<isAffiliatedTo>Crewe_Alexandra_F.C.,	<Bulgaria>
<isAffiliatedTo>Hellas_Verona_F.C.,	<Northern_Ireland>
<isLocatedIn>Florida,	<Cameroon>
<isAffiliatedTo>Stoke_City_F.C.,	<United_States>
<isAffiliatedTo>Hereford_United_F.C.,	<India>
<actedIn>Star_Wars_Holiday_Special,	<India>
<playsFor>Partick_Thistle_F.C.,	<Switzerland>
<isAffiliatedTo>Walsall_F.C.,<playsFor>Walsall_F.C.,<playsFor>Tranmere_Rovers_F.C.,	<Serbia>
<isAffiliatedTo>Birmingham_City_F.C.,	<Jamaica>
<isAffiliatedTo>Oldham_Athletic_A.F.C.,	<Belgium>
<playsFor>Port_Vale_F.C.,	<Russia>
<hasWonPrize>Tony_Award,<actedIn>The_Spiderwick_Chronicles_(film),	<El_Salvador>
<isAffiliatedTo>Doncaster_Rovers_F.C.,	<Belgium>
<owns>Marvel_Comics,	<Nigeria>
<isLocatedIn>United_States,	<Barbados>
<actedIn>There's_Something_About_Mary,	<Norway>
<isAffiliatedTo>Leicester_City_F.C.,	<Martinique>
<isAffiliatedTo>Crystal_Palace_F.C.,	<Martinique>
<isAffiliatedTo>Watford_F.C.,	<Jamaica>
<playsFor>Cambridge_United_F.C.,	<Sweden>
<hasWonPrize>Laurence_Olivier_Award,	<Greece>
<playsFor>A.C._ChievoVerona,	<Austria>
<playsFor>Kidderminster_Harriers_F.C.,	<Bangladesh>
<hasWonPrize>Independent_Spirit_Award_for_Best_Male_Lead,	<Germany>
<playsFor>S.S._Lazio,	<Barbados>
<isAffiliatedTo>F.C._Bari_1908,<isAffiliatedTo>Inter_Milan,	<Hungary>
<actedIn>The_Love_Guru,	<Democratic_Republic_of_the_Congo>
<actedIn>Jonah_Hex_(film),	<Germany>
<wasBornIn>Brooklyn,<hasWonPrize>Grammy_Award,	<Italy>
<actedIn>Gallipoli_(1981_film),	<Kazakhstan>
<actedIn>Fantastic_Mr._Fox_(film),	<Scotland>
<isLocatedIn>Iran,	<Puerto_Rico>
<isAffiliatedTo>Sunderland_A.F.C.,	<Martinique>
<actedIn>Scott_Pilgrim_vs._the_World,	<Chile>
<hasWonPrize>Nebula_Award,	<Denmark>
<playsFor>Nottingham_Forest_F.C.,	<Italy>
<playsFor>S.S._Lazio,	<Northern_Ireland>
<wasBornIn>Chester,	<England>
<actedIn>Take_Shelter,<actedIn>Man_of_Steel_(film),	<Chile>
<wasBornIn>Stuttgart,	<Greece>
<isAffiliatedTo>Southend_United_F.C.,	<Republic_of_the_Congo>
<wasBornIn>Decatur,_Georgia,	<Russia>
<wasBornIn>Amsterdam,	<England>
<hasOfficialLanguage>English_language,	<Niger>
<isAffiliatedTo>Peterborough_United_F.C.,	<Nigeria>
<playsFor>Oldham_Athletic_A.F.C.,	<United_States>
<isAffiliatedTo>Sheffield_United_F.C.,	<Spain>
<influences>J._M._Coetzee,	<Martinique>
<playsFor>Grays_Athletic_F.C.,	<United_Kingdom>
<isAffiliatedTo>Galatasaray_S.K._(football),	<Israel>
<isMarriedTo>Diane_Sawyer,	<Nigeria>
<isAffiliatedTo>Bolton_Wanderers_F.C.,	<Slovenia>
<playsFor>Preston_North_End_F.C.,	<Belgium>
<playsFor>Reading_F.C.,	<Martinique>
<owns>A.C._Milan,	<Cape_Verde>
<isLocatedIn>Milwaukee,	<Mali>
<isAffiliatedTo>Frosinone_Calcio,	<Bahrain>
<isAffiliatedTo>Levante_UD,	<Norway>
<isLocatedIn>Louisiana,	<Bahrain>
<playsFor>Calcio_Catania,	<India>
<isAffiliatedTo>Liberty_Professionals_F.C.,	<Kazakhstan>
<wroteMusicFor>Girl,_Interrupted_(film),	<Bulgaria>
<isAffiliatedTo>Charlton_Athletic_F.C.,	<Austria>
<owns>Amblin_Entertainment,	<Bulgaria>
<isAffiliatedTo>Wolverhampton_Wanderers_F.C.,	<Wales>
<actedIn>Super_(2010_American_film),	<El_Salvador>
<playsFor>Farnborough_F.C.,	<Serbia>
<wasBornIn>Louisville,_Kentucky,	<Netherlands>
<livesIn>Los_Angeles,	<Tanzania>
<isAffiliatedTo>Brentford_F.C.,	<Cameroon>
<created>The_Goodbye_Girl,	<Iran>
<isAffiliatedTo>Barnsley_F.C.,	<Italy>
<participatedIn>Libyan_Civil_War_(2011),	<Bangladesh>
<playsFor>Farnborough_F.C.,	<India>
<isLocatedIn>Massachusetts,	<Ukraine>
<hasCapital>Fredericton,	<Puerto_Rico>
<isLocatedIn>Massachusetts,	<Northern_Ireland>
<isLocatedIn>United_States,	<Argentina>
<dealsWith>Germany,	<United_States>
<isAffiliatedTo>Welling_United_F.C.,	<Switzerland>
<isAffiliatedTo>England_national_football_team,	<Sweden>
<actedIn>Face/Off,<actedIn>Moonstruck,	<Greece>
<wasBornIn>Copenhagen,	<Wales>
<isAffiliatedTo>Manager_(association_football),<playsFor>Newcastle_United_F.C.,	<Dominica>
<wasBornIn>Belgrade,	<Greece>
<isLocatedIn>Cleveland,	<Senegal>
<wasBornIn>London,	<Puerto_Rico>
<isLocatedIn>Stockholm,	<Canada>
<playsFor>Harrogate_Town_F.C.,	<Northern_Ireland>
<created>Julie_&_Julia,	<Ukraine>
<actedIn>When_We_Were_Kings,	<Panama>
<isLocatedIn>Rouen,	<Niger>
<isLocatedIn>United_States,	<Dominica>
<livesIn>Monaco,	<Tanzania>
<isAffiliatedTo>Mansfield_Town_F.C.,	<Norway>
<isAffiliatedTo>AIK_Fotboll,	<Iran>
<isLocatedIn>California,	<Norway>
<isAffiliatedTo>K.R.C._Genk,	<Sweden>
<isAffiliatedTo>GNK_Dinamo_Zagreb,	<Democratic_Republic_of_the_Congo>
<hasOfficialLanguage>Turkish_language,<participatedIn>Napoleonic_Wars,	<Niger>
<isAffiliatedTo>Derby_County_F.C.,	<Netherlands>
<participatedIn>Operation_Enduring_Freedom_–_Horn_of_Africa,	<India>
<hasWonPrize>Primetime_Emmy_Award,	<Austria>
<isAffiliatedTo>A.C._ChievoVerona,	<Niger>
<actedIn>Best_in_Show_(film),	<Panama>
<isLocatedIn>United_Kingdom,	<Niger>
<playsFor>A.C._Milan,	<Netherlands>
<isAffiliatedTo>Northampton_Town_F.C.,	<Russia>
<actedIn>Lost_Highway_(film),	<Norway>
<playsFor>Stevenage_F.C.,	<Croatia>
<playsFor>Tamworth_F.C.,	<Northern_Ireland>
<actedIn>The_Phantom_(1996_film),	<Belgium>
<isAffiliatedTo>FC_Barcelona_B,	<Cyprus>
<isAffiliatedTo>SBV_Vitesse,	<Republic_of_Ireland>
<isAffiliatedTo>West_Ham_United_F.C.,	<Republic_of_the_Congo>
<wasBornIn>Newark,_New_Jersey,	<Scotland>
<isAffiliatedTo>Milton_Keynes_Dons_F.C.,	<Scotland>
<isAffiliatedTo>Swindon_Town_F.C.,	<Democratic_Republic_of_the_Congo>
<isAffiliatedTo>Kettering_Town_F.C.,	<Senegal>
<livesIn>Santa_Monica,_California,	<Bahrain>
<isAffiliatedTo>Brighton_&_Hove_Albion_F.C.,	<Dominica>
<isAffiliatedTo>Shrewsbury_Town_F.C.,	<United_Arab_Emirates>
<isAffiliatedTo>Aberdeen_F.C.,	<Democratic_Republic_of_the_Congo>
<isAffiliatedTo>Portsmouth_F.C.,	<Italy>
<isAffiliatedTo>Bury_F.C.,	<Barbados>
<playsFor>Swindon_Town_F.C.,	<Mali>
<actedIn>Bulworth,	<Japan>
<isLocatedIn>Piedmont,	<Argentina>
<isAffiliatedTo>SuperSport_United_F.C.,	<Republic_of_Ireland>
<dealsWith>China,	<Netherlands>
<isAffiliatedTo>Hull_City_A.F.C.,	<Israel>
<playsFor>Port_Vale_F.C.,	<Monaco>
<directed>Battleship_(film),<created>Friday_Night_Lights_(TV_series),	<Croatia>
<graduatedFrom>Syracuse_University,	<Argentina>
<isAffiliatedTo>Leicester_City_F.C.,	<France>
<isAffiliatedTo>Leicester_City_F.C.,	<Italy>
<wasBornIn>Edinburgh,	<Barbados>
<playsFor>Aston_Villa_F.C.,	<United_Kingdom>
<playsFor>Sunderland_A.F.C.,<isAffiliatedTo>Clyde_F.C.,	<Dominica>
<playsFor>Queens_Park_Rangers_F.C.,	<Australia>
<wasBornIn>Newport,_Wales,	<Niger>
<wasBornIn>Leicester,	<Democratic_Republic_of_the_Congo>
<isAffiliatedTo>Scunthorpe_United_F.C.,	<France>
<hasWonPrize>Emmy_Award,	<Panama>
<isAffiliatedTo>Plymouth_Argyle_F.C.,	<Scotland>
<isAffiliatedTo>Wycombe_Wanderers_F.C.,	<Netherlands>
<actedIn>Quo_Vadis_(1951_film),	<India>
<playsFor>Barrow_A.F.C.,	<Greece>
<wasBornIn>The_Bronx,	<Cyprus>
<playsFor>Dover_Athletic_F.C.,	<Slovenia>
<hasWonPrize>Astrid_Lindgren_Memorial_Award,	<Bangladesh>
<hasWonPrize>Edgar_Award,	<Netherlands>
<playsFor>Rangers_F.C.,	<Greece>
<hasNeighbor>Ukraine,	<Serbia>
<isLocatedIn>Italy,	<Wales>
<isLocatedIn>Como,	<Tanzania>
<created>Royal_Victorian_Order,	<El_Salvador>
<wasBornIn>Kolkata,	<Russia>
<wroteMusicFor>Beloved_(film),	<Italy>
<isAffiliatedTo>Panionios_F.C.,	<Mali>
<isLocatedIn>Jaipur,	<Poland>
<wasBornIn>Bangalore,	<Tanzania>
<actedIn>Sunshine_(1999_film),<actedIn>The_English_Patient_(film),	<Poland>
<playsFor>Al-Gharafa_Sports_Club,	<France>
<isAffiliatedTo>Puebla_F.C.,	<Argentina>
<isAffiliatedTo>Odense_Boldklub,	<Tanzania>
<wasBornIn>Los_Angeles,	<Dominica>
<wroteMusicFor>Gandhi_(film),	<Slovenia>
<isAffiliatedTo>A.F.C._Bournemouth,	<Tanzania>
<actedIn>Smokin'_Aces,	<United_States>
<wasBornIn>Paris,	<Israel>
<playsFor>San_Jose_Earthquakes,	<United_Kingdom>
<actedIn>The_Town_(2010_film),<actedIn>Starter_for_10_(film),	<Bulgaria>
<playsFor>Macclesfield_Town_F.C.,	<Argentina>
<graduatedFrom>Leiden_University,	<Sweden>
<playsFor>A.C._ChievoVerona,	<Tanzania>
<actedIn>Anne_of_the_Thousand_Days,	<United_States>
<wasBornIn>Beverly_Hills,_California,	<Norway>
<actedIn>The_Goodbye_Girl,	<El_Salvador>
<actedIn>The_Cabin_in_the_Woods,	<Scotland>
<wasBornIn>Cambridge,	<Brazil>
<isAffiliatedTo>Chesterfield_F.C.,	<Panama>
<influences>Whoopi_Goldberg,	<Monaco>
<wasBornIn>Brooklyn,	<Barbados>
<isAffiliatedTo>Aston_Villa_F.C.,	<Norway>
<playsFor>Shelbourne_F.C.,	<France>
<created>Def_Jam_Recordings,	<Iran>
<isLocatedIn>Mumbai,	<Iran>
<influences>Charles_Stross,	<El_Salvador>
<playsFor>Cardiff_City_F.C.,	<Mali>
<diedIn>Los_Angeles,<graduatedFrom>Harvard_University,	<Mali>
<actedIn>Lost_Highway_(film),	<Germany>
<influences>Arthur_Conan_Doyle,	<Denmark>
<hasWonPrize>Nebula_Award,	<Scotland>
<isAffiliatedTo>Udinese_Calcio,	<France>
<directed>Pinocchio_(2002_film),	<Niger>
<isLocatedIn>Wyoming,	<Switzerland>
<actedIn>In_the_Heat_of_the_Night_(film),	<France>
<isAffiliatedTo>Bologna_F.C._1909,	<Poland>
<dealsWith>Netherlands,	<United_Arab_Emirates>
<playsFor>U.C._Sampdoria,	<Tanzania>
<isMarriedTo>Jane_Wyman,	<Scotland>
<isAffiliatedTo>Manchester_United_F.C.,	<Tanzania>
<isAffiliatedTo>Barnsley_F.C.,	<Brazil>
<wasBornIn>New_York_City,	<Australia>
<actedIn>Sunshine_(1999_film),	<England>
<playsFor>FC_Baku,	<Hungary>
<isAffiliatedTo>Southampton_F.C.,	<Italy>
<participatedIn>War_of_the_Fourth_Coalition,	<India>
<hasNeighbor>Democratic_Republic_of_the_Congo,	<Japan>
<isAffiliatedTo>Plymouth_Argyle_F.C.,<isAffiliatedTo>Tranmere_Rovers_F.C.,	<Panama>
<isAffiliatedTo>Birmingham_City_F.C.,	<Brazil>
<isAffiliatedTo>Ayr_United_F.C.,	<United_Kingdom>
<actedIn>Smokin'_Aces,	<Chile>
<isLocatedIn>Darmstadt,	<Germany>
<isAffiliatedTo>Inter_Milan,	<Spain>
<isAffiliatedTo>Leyton_Orient_F.C.,	<Serbia>
<isPoliticianOf>Iraq,	<Japan>
<isLocatedIn>Saint_Petersburg,	<Wales>
<actedIn>ER_(TV_series),	<Ukraine>
<actedIn>Puss_in_Boots_(2011_film),	<Cyprus>
<isLocatedIn>United_States,	<Dominica>
<actedIn>Evil_Angels_(film),	<Switzerland>
<isAffiliatedTo>Darlington_F.C.,	<Mali>
<isAffiliatedTo>Barnet_F.C.,	<Bangladesh>
<isAffiliatedTo>Leeds_United_F.C.,	<Russia>
<isLocatedIn>England,	<Switzerland>
<isLocatedIn>Illinois,	<Russia>
<isAffiliatedTo>Reading_F.C.,	<Cyprus>
<isLocatedIn>Los_Angeles_County,_California,	<Jamaica>
<isLocatedIn>United_States,	<Australia>
<isAffiliatedTo>Portsmouth_F.C.,	<Bangladesh>
<isAffiliatedTo>Gillingham_F.C.,	<Cyprus>
<isAffiliatedTo>Eastleigh_F.C.,	<Bahrain>
<isAffiliatedTo>West_Ham_United_F.C.,<isAffiliatedTo>Leyton_Orient_F.C.,	<Wales>
<isAffiliatedTo>Aldershot_Town_F.C.,	<Ukraine>
<isAffiliatedTo>Notts_County_F.C.,<playsFor>Notts_County_F.C.,	<United_Arab_Emirates>
<isAffiliatedTo>A.F.C._Bournemouth,	<Australia>
<isLocatedIn>Sacramento,_California,	<Republic_of_the_Congo>
<actedIn>Click_(2006_film),	<Cameroon>
<actedIn>The_Name_of_the_Rose_(film),	<Barbados>
<wasBornIn>Chicago,	<Serbia>
<dealsWith>Italy,	<Cape_Verde>
<wasBornIn>Perth,	<Poland>
<isLocatedIn>Shanghai,	<Switzerland>
<wasBornIn>Patna,	<Niger>
<playsFor>Oldham_Athletic_A.F.C.,	<Germany>
<diedIn>London,	<United_Kingdom>
<actedIn>Around_the_World_in_80_Days_(1956_film),<actedIn>Cannonball_Run_II,	<Monaco>
<isAffiliatedTo>Hapoel_Haifa_F.C.,	<Republic_of_Ireland>
<hasWonPrize>Independent_Spirit_Awards,	<Denmark>
<playsFor>Chesterfield_F.C.,	<Monaco>
<isAffiliatedTo>Swansea_City_A.F.C.,	<England>
<wasBornIn>New_York_City,	<Israel>
<isLocatedIn>Fresno,_California,	<Germany>
<playsFor>Altrincham_F.C.,<isAffiliatedTo>Lincoln_City_F.C.,	<Barbados>
<actedIn>Shakespeare_in_Love,	<Argentina>
<playsFor>Manchester_City_F.C.,	<Israel>
<isAffiliatedTo>FC_Utrecht,	<United_States>
<isAffiliatedTo>Southampton_F.C.,<wasBornIn>Oxford,	<Cameroon>
<isAffiliatedTo>Northwich_Victoria_F.C.,	<Mali>
<isAffiliatedTo>Sheffield_United_F.C.,	<Mali>
<isAffiliatedTo>Chesterfield_F.C.,	<Belgium>
<isLocatedIn>Netherlands,	<Russia>
<actedIn>Starsky_&_Hutch_(film),	<Monaco>
<hasWonPrize>Independent_Spirit_Award_for_Best_Director,	<Austria>
<dealsWith>United_Arab_Emirates,	<Nigeria>
<isAffiliatedTo>South_Korea_national_football_team,	<Israel>
<livesIn>Switzerland,	<Norway>
<isLocatedIn>Indian_Ocean,	<Belgium>
<isLocatedIn>Missouri,<isLocatedIn>St._Louis,	<Republic_of_Ireland>
<isLocatedIn>Canton,_Ohio,	<Bangladesh>
<isLocatedIn>Fredericksburg,_Virginia,	<Panama>
<isLocatedIn>Mexico,	<Hungary>
<isAffiliatedTo>A.C._Perugia_Calcio,<playsFor>A.C._Perugia_Calcio,	<Norway>
<isAffiliatedTo>Mansfield_Town_F.C.,	<Martinique>
<playsFor>Aston_Villa_F.C.,	<Senegal>
<isAffiliatedTo>Hednesford_Town_F.C.,	<Cyprus>
<isAffiliatedTo>Shrewsbury_Town_F.C.,	<Argentina>
<playsFor>ACF_Fiorentina,	<Belgium>
<isAffiliatedTo>Ebbsfleet_United_F.C.,	<Australia>
<isAffiliatedTo>Luton_Town_F.C.,	<United_States>
<isAffiliatedTo>Luton_Town_F.C.,	<England>
<isAffiliatedTo>Scunthorpe_United_F.C.,	<Switzerland>
<hasWonPrize>Independent_Spirit_Awards,	<Kazakhstan>
<hasChild>Liv_Tyler,	<El_Salvador>
<hasWonPrize>Academy_Award_for_Best_Adapted_Screenplay,	<Greece>
<isAffiliatedTo>Oldham_Athletic_A.F.C.,	<Chile>
<playsFor>Wycombe_Wanderers_F.C.,	<Germany>
<isAffiliatedTo>Gillingham_F.C.,	<Argentina>
<playsFor>Blackburn_Rovers_F.C.,	<Martinique>
<isLocatedIn>British_Columbia,	<Serbia>
<directed>The_Firm_(1993_film),	<United_Kingdom>
<actedIn>Oscar_(1991_film),	<Chile>
<diedIn>New_York,	<Japan>
<hasCapital>Damascus,	<Wales>
<dealsWith>Switzerland,	<Democratic_Republic_of_the_Congo>
<isLocatedIn>United_States,	<Kazakhstan>
<isLocatedIn>United_States,	<Panama>
<isAffiliatedTo>Juventus_F.C.,	<Hungary>
<hasWonPrize>Tony_Award,	<Austria>
<isAffiliatedTo>Canada_men's_national_soccer_team,	<Nigeria>
<wasBornIn>Manchester,	<United_Arab_Emirates>
<isLocatedIn>New_York,	<Ukraine>
<isLocatedIn>United_States,	<Bangladesh>
<isLocatedIn>United_States,	<United_Kingdom>
<isLocatedIn>Germany,	<Greece>
<isLocatedIn>Germany,	<Cape_Verde>
<isLocatedIn>United_States,	<Republic_of_Ireland>
<isLocatedIn>United_States,	<Canada>
<owns>Disney_Interactive_Studios,	<Croatia>
<actedIn>Bright_Star_(film),	<El_Salvador>
<actedIn>American_Pie_(film),	<Sweden>
<wroteMusicFor>In_the_Bedroom,	<Norway>
<wasBornIn>Tulsa,_Oklahoma,	<Nigeria>
<isAffiliatedTo>Millwall_F.C.,	<England>
<actedIn>Terry_Pratchett's_The_Colour_of_Magic,	<United_Kingdom>
<wasBornIn>Glendale,_California,	<Slovenia>
<isAffiliatedTo>Coventry_City_F.C.,	<Poland>
<isAffiliatedTo>Gateshead_F.C.,	<Croatia>
<isLocatedIn>Chiyoda,_Tokyo,	<United_States>
<isLocatedIn>Japan,	<Greece>
<isAffiliatedTo>Huddersfield_Town_A.F.C.,<isAffiliatedTo>Sheffield_United_F.C.,<isAffiliatedTo>Barrow_A.F.C.,	<Cyprus>
<isAffiliatedTo>Barnet_F.C.,	<Italy>
<isMarriedTo>Drew_Barrymore,	<Jamaica>
<actedIn>The_Green_Mile_(film),	<Poland>
<isAffiliatedTo>Burnley_F.C.,	<Russia>
<actedIn>MASH_(film),	<United_Arab_Emirates>
<isAffiliatedTo>HNK_Hajduk_Split,	<France>
<isAffiliatedTo>A.F.C._Bournemouth,<isAffiliatedTo>Stockport_County_F.C.,	<Serbia>
<wasBornIn>Edmonton,	<Serbia>
<isAffiliatedTo>Sheffield_Wednesday_F.C.,	<Canada>
<isAffiliatedTo>Nottingham_Forest_F.C.,	<Ukraine>
<isAffiliatedTo>Northampton_Town_F.C.,	<Panama>
<isAffiliatedTo>England_national_football_team,	<Martinique>
<playsFor>Birmingham_City_F.C.,	<Cape_Verde>
<playsFor>Shrewsbury_Town_F.C.,	<Cyprus>
<isAffiliatedTo>Bristol_Rovers_F.C.,	<Cyprus>
<isAffiliatedTo>Manchester_City_F.C.,	<Denmark>
<playsFor>Wellington_Phoenix_FC,	<Bangladesh>
<wasBornIn>Paris,	<Slovenia>
<isAffiliatedTo>Atromitos_F.C.,	<Nigeria>
<isLocatedIn>Europe,	<Bulgaria>
<wroteMusicFor>The_Social_Network,	<United_Arab_Emirates>
<isAffiliatedTo>Crystal_Palace_F.C.,<playsFor>Wycombe_Wanderers_F.C.,	<Jamaica>
<isAffiliatedTo>AEK_Athens_F.C.,	<Barbados>
<isAffiliatedTo>Millwall_F.C.,	<Republic_of_the_Congo>
<dealsWith>Iraq,	<Denmark>
<isLocatedIn>Europe,	<United_Arab_Emirates>
<isAffiliatedTo>Reading_F.C.,	<Northern_Ireland>
<actedIn>The_Avengers_(1998_film),	<Scotland>
<participatedIn>Korean_War,	<Wales>
<participatedIn>Operation_Enduring_Freedom,	<Bahrain>
<happenedIn>Somalia,	<Austria>
<participatedIn>Operation_Serval,<participatedIn>Apache_Wars,	<Bangladesh>
<isLocatedIn>United_States,	<Northern_Ireland>
<isLocatedIn>Vienna,	<United_Kingdom>
<actedIn>The_Caine_Mutiny_(film),	<Hungary>
<diedIn>Los_Angeles,	<Panama>
<isLocatedIn>California,	<Australia>
<isLocatedIn>British_Columbia,	<Poland>
<isAffiliatedTo>Real_Madrid_C.F.,	<China>
<dealsWith>Spain,	<Spain>
<isLocatedIn>United_States,	<Mali>
<isLocatedIn>France,	<Brazil>
<isLocatedIn>Asia,	<Dominica>
<actedIn>Psycho_(1998_film),	<Republic_of_the_Congo>
<hasWonPrize>Writers_Guild_of_America_Award,	<Denmark>
<isAffiliatedTo>Red_Star_Belgrade,	<Nigeria>
<livesIn>Georgia_(U.S._state),	<Iran>
<playsFor>Chelmsford_City_F.C.,	<Tanzania>
<hasWonPrize>Edgar_Award,	<Belgium>
<isLocatedIn>Burbank,_California,	<Brazil>
<happenedIn>North_America,	<Northern_Ireland>
<happenedIn>Kingdom_of_Great_Britain,<happenedIn>Kingdom_of_Naples,	<Republic_of_the_Congo>
<happenedIn>Germany,	<Denmark>
<happenedIn>South_America,	<Barbados>
<isLocatedIn>California,	<Northern_Ireland>
<isAffiliatedTo>Swansea_City_A.F.C.,	<Slovenia>
<isAffiliatedTo>Sheffield_Wednesday_F.C.,	<Poland>
<isAffiliatedTo>Stoke_City_F.C.,<isAffiliatedTo>Oxford_United_F.C.,	<Germany>
<isAffiliatedTo>Gillingham_F.C.,	<Republic_of_Ireland>
<isAffiliatedTo>Port_Vale_F.C.,	<Democratic_Republic_of_the_Congo>
<isAffiliatedTo>Grays_Athletic_F.C.,	<Denmark>
<isLocatedIn>Utah,	<Martinique>
<isLocatedIn>Nazi_Germany,	<Senegal>
<created>Heroes_(TV_series),	<Barbados>
<hasWonPrize>Nobel_Prize_in_Physics,	<Ukraine>
<isLocatedIn>City_of_Westminster,	<Poland>
<isLocatedIn>New_York,	<Ukraine>
<isLocatedIn>Los_Angeles,	<Ukraine>
<isAffiliatedTo>Leeds_United_F.C.,	<India>
<actedIn>Bewitched_(2005_film),	<United_States>
<actedIn>Mississippi_Burning,<actedIn>Spider-Man_(2002_film),	<Israel>
<livesIn>Cambridge,	<England>
<isLocatedIn>Canada,	<Bahrain>
<isLocatedIn>Worcester,_Massachusetts,	<Niger>
<isLocatedIn>Sussex,	<Brazil>
<isLocatedIn>China,	<Brazil>
<isLocatedIn>United_States,	<Australia>
<isLocatedIn>New_Haven,_Connecticut,	<Chile>
<isLocatedIn>New_Haven,_Connecticut,	<Italy>
<isMarriedTo>John_Lennon,	<Poland>
<isLocatedIn>United_Kingdom,	<Bahrain>
<isLocatedIn>Trumbull_County,_Ohio,	<France>
<isAffiliatedTo>Morocco_national_football_team,	<Jamaica>
<isAffiliatedTo>Perth_Glory_FC,	<Bulgaria>
<isAffiliatedTo>FK_Vojvodina,	<Israel>
<isLocatedIn>Norway,	<Republic_of_Ireland>
<isAffiliatedTo>A.C._Cesena,	<United_States>
